,案號,區域,同意票數,不同意票數,有效票數,無效票數,投票數,投票權人數,投票率(%),有效同意票數對投票權人數百分比(%)
0,第7案,全國,7955753,2109157,10064910,715140,10780050,19757067,54.56%,40.27%
0,第7案,臺北市,924026,277072,1201098,77356,1278454,2228430,57.37%,41.47%
0,第7案,臺北市松山區,72344,21698,94042,5769,99811,169278,58.96%,42.74%
0,第7案,臺北市信義區,80160,23245,103405,6057,109462,190444,57.48%,42.09%
0,第7案,臺北市大安區,104681,32294,136975,7388,144363,252645,57.14%,41.43%
0,第7案,臺北市中山區,78649,25050,103699,7022,110721,195148,56.74%,40.3%
0,第7案,臺北市中正區,54089,16359,70448,4232,74680,128292,58.21%,42.16%
0,第7案,臺北市大同區,42497,14769,57266,4486,61752,107557,57.41%,39.51%
0,第7案,臺北市萬華區,64385,19585,83970,6622,90592,164020,55.23%,39.25%
0,第7案,臺北市文山區,101174,26288,127462,7798,135260,227211,59.53%,44.53%
0,第7案,臺北市南港區,43217,12009,55226,3158,58384,101907,57.29%,42.41%
0,第7案,臺北市內湖區,101149,28663,129812,7239,137051,236824,57.87%,42.71%
0,第7案,臺北市士林區,96156,31493,127649,9864,137513,241854,56.86%,39.76%
0,第7案,臺北市北投區,85525,25619,111144,7721,118865,213250,55.74%,40.11%
0,第7案,新北市,1346167,373414,1719581,127273,1846854,3375513,54.71%,39.88%
0,第7案,新北市板橋區,183642,54962,238604,19309,257913,463411,55.66%,39.63%
0,第7案,新北市三重區,128111,39417,167528,16104,183632,329846,55.67%,38.84%
0,第7案,新北市中和區,146208,37338,183546,12119,195665,355978,54.97%,41.07%
0,第7案,新北市永和區,83228,20414,103642,6419,110061,187798,58.61%,44.32%
0,第7案,新北市新莊區,140045,41204,181249,13774,195023,344981,56.53%,40.59%
0,第7案,新北市新店區,113797,26226,140023,8228,148251,264053,56.14%,43.1%
0,第7案,新北市樹林區,60667,17206,77873,5482,83355,152102,54.8%,39.89%
0,第7案,新北市鶯歌區,27167,7924,35091,2344,37435,71645,52.25%,37.92%
0,第7案,新北市三峽區,35739,10099,45838,3190,49028,94291,52%,37.9%
0,第7案,新北市淡水區,56960,15439,72399,4367,76766,147272,52.13%,38.68%
0,第7案,新北市汐止區,67547,18065,85612,5665,91277,173831,52.51%,38.86%
0,第7案,新北市瑞芳區,12211,3277,15488,1236,16724,35036,47.73%,34.85%
0,第7案,新北市土城區,78924,22140,101064,7807,108871,200783,54.22%,39.31%
0,第7案,新北市蘆洲區,62988,19193,82181,6888,89069,167457,53.19%,37.61%
0,第7案,新北市五股區,27379,7871,35250,2856,38106,72443,52.6%,37.79%
0,第7案,新北市泰山區,26020,6947,32967,2173,35140,64252,54.69%,40.5%
0,第7案,新北市林口區,36042,9434,45476,2656,48132,86203,55.84%,41.81%
0,第7案,新北市深坑區,8193,2201,10394,716,11110,20624,53.87%,39.73%
0,第7案,新北市石碇區,2358,719,3077,309,3386,6861,49.35%,34.37%
0,第7案,新北市坪林區,2075,535,2610,311,2921,5891,49.58%,35.22%
0,第7案,新北市三芝區,6999,1927,8926,704,9630,20119,47.87%,34.79%
0,第7案,新北市石門區,3899,1018,4917,509,5426,10528,51.54%,37.03%
0,第7案,新北市八里區,12684,3493,16177,1263,17440,32970,52.9%,38.47%
0,第7案,新北市平溪區,1428,412,1840,190,2030,4321,46.98%,33.05%
0,第7案,新北市雙溪區,2739,737,3476,373,3849,7999,48.12%,34.24%
0,第7案,新北市貢寮區,3309,1075,4384,423,4807,11279,42.62%,29.34%
0,第7案,新北市金山區,6853,1860,8713,843,9556,18978,50.35%,36.11%
0,第7案,新北市萬里區,6883,1811,8694,854,9548,19297,49.48%,35.67%
0,第7案,新北市烏來區,2072,470,2542,161,2703,5264,51.35%,39.36%
0,第7案,桃園市,697528,173333,870861,48893,919754,1801823,51.05%,38.71%
0,第7案,桃園市桃園區,135663,36174,171837,9359,181196,359790,50.36%,37.71%
0,第7案,桃園市中壢區,134509,31525,166034,8758,174792,334402,52.27%,40.22%
0,第7案,桃園市大溪區,30058,7843,37901,2974,40875,78285,52.21%,38.4%
0,第7案,桃園市楊梅區,54109,12102,66211,3373,69584,137917,50.45%,39.23%
0,第7案,桃園市蘆竹區,48141,12964,61105,3805,64910,129252,50.22%,37.25%
0,第7案,桃園市大園區,26894,7155,34049,2005,36054,73900,48.79%,36.39%
0,第7案,桃園市龜山區,47936,12769,60705,3366,64071,131702,48.65%,36.4%
0,第7案,桃園市八德區,62058,15724,77782,4842,82624,165065,50.06%,37.6%
0,第7案,桃園市龍潭區,42077,9102,51179,2699,53878,101574,53.04%,41.42%
0,第7案,桃園市平鎮區,74739,17335,92074,4474,96548,183560,52.6%,40.72%
0,第7案,桃園市新屋區,17090,4471,21561,1267,22828,41461,55.06%,41.22%
0,第7案,桃園市觀音區,20514,5326,25840,1616,27456,55149,49.79%,37.2%
0,第7案,桃園市復興區,3740,843,4583,355,4938,9766,50.56%,38.3%
0,第7案,臺中市,1013174,234816,1247990,71112,1319102,2295642,57.46%,44.13%
0,第7案,臺中市中區,6132,1541,7673,468,8141,14696,55.4%,41.73%
0,第7案,臺中市東區,28395,6994,35389,2147,37536,64291,58.38%,44.17%
0,第7案,臺中市南區,48518,11525,60043,3309,63352,103643,61.13%,46.81%
0,第7案,臺中市西區,41855,10696,52551,2576,55127,95040,58%,44.04%
0,第7案,臺中市北區,53751,12471,66222,3239,69461,124621,55.74%,43.13%
0,第7案,臺中市西屯區,82825,18412,101237,4948,106185,183814,57.77%,45.06%
0,第7案,臺中市南屯區,63052,14504,77556,3946,81502,135448,60.17%,46.55%
0,第7案,臺中市北屯區,100833,22423,123256,6126,129382,227720,56.82%,44.28%
0,第7案,臺中市豐原區,61483,15505,76988,4660,81648,136658,59.75%,44.99%
0,第7案,臺中市東勢區,18958,4311,23269,1783,25052,43181,58.02%,43.9%
0,第7案,臺中市大甲區,27122,6558,33680,2271,35951,63069,57%,43%
0,第7案,臺中市清水區,32206,7100,39306,2489,41795,71528,58.43%,45.03%
0,第7案,臺中市沙鹿區,32234,7425,39659,2329,41988,74207,56.58%,43.44%
0,第7案,臺中市梧棲區,20303,4831,25134,1659,26793,47040,56.96%,43.16%
0,第7案,臺中市后里區,20022,4396,24418,1587,26005,44962,57.84%,44.53%
0,第7案,臺中市神岡區,24223,5774,29997,1950,31947,54565,58.55%,44.39%
0,第7案,臺中市潭子區,39569,8853,48422,2553,50975,89487,56.96%,44.22%
0,第7案,臺中市大雅區,33608,7469,41077,2236,43313,77189,56.11%,43.54%
0,第7案,臺中市新社區,8246,1889,10135,651,10786,20860,51.71%,39.53%
0,第7案,臺中市石岡區,5735,1379,7114,477,7591,12880,58.94%,44.53%
0,第7案,臺中市外埔區,12116,2667,14783,912,15695,27059,58%,44.78%
0,第7案,臺中市大安區,7288,1691,8979,734,9713,16520,58.8%,44.12%
0,第7案,臺中市烏日區,27379,6443,33822,2087,35909,61705,58.19%,44.37%
0,第7案,臺中市大肚區,21090,4776,25866,1563,27429,47457,57.8%,44.44%
0,第7案,臺中市龍井區,26747,6871,33618,1884,35502,63584,55.83%,42.07%
0,第7案,臺中市霧峰區,25277,5735,31012,2276,33288,55225,60.28%,45.77%
0,第7案,臺中市太平區,66181,14725,80906,4802,85708,157926,54.27%,41.91%
0,第7案,臺中市大里區,73521,16988,90509,5141,95650,171769,55.69%,42.8%
0,第7案,臺中市和平區,4505,864,5369,309,5678,9498,59.78%,47.43%
0,第7案,臺南市,572230,167275,739505,59206,798711,1594821,50.08%,35.88%
0,第7案,臺南市新營區,23334,6243,29577,1931,31508,64949,48.51%,35.93%
0,第7案,臺南市鹽水區,7197,2115,9312,884,10196,22121,46.09%,32.53%
0,第7案,臺南市白河區,7115,2194,9309,945,10254,24894,41.19%,28.58%
0,第7案,臺南市柳營區,6416,1700,8116,880,8996,18804,47.84%,34.12%
0,第7案,臺南市後壁區,6384,1789,8173,1083,9256,20841,44.41%,30.63%
0,第7案,臺南市東山區,4639,1339,5978,743,6721,18471,36.39%,25.12%
0,第7案,臺南市麻豆區,12768,3962,16730,1110,17840,37963,46.99%,33.63%
0,第7案,臺南市下營區,6734,1827,8561,882,9443,20947,45.08%,32.15%
0,第7案,臺南市六甲區,6274,1934,8208,904,9112,19144,47.6%,32.77%
0,第7案,臺南市官田區,6127,1935,8062,681,8743,18675,46.82%,32.81%
0,第7案,臺南市大內區,2868,708,3576,450,4026,8654,46.52%,33.14%
0,第7案,臺南市佳里區,19007,4960,23967,1833,25800,50407,51.18%,37.71%
0,第7案,臺南市學甲區,7444,2145,9589,862,10451,22567,46.31%,32.99%
0,第7案,臺南市西港區,7029,1898,8927,665,9592,21564,44.48%,32.6%
0,第7案,臺南市七股區,6088,1601,7689,715,8404,19950,42.13%,30.52%
0,第7案,臺南市將軍區,5144,1406,6550,631,7181,17754,40.45%,28.97%
0,第7案,臺南市北門區,2791,714,3505,286,3791,9925,38.2%,28.12%
0,第7案,臺南市新化區,13968,3880,17848,1819,19667,37296,52.73%,37.45%
0,第7案,臺南市善化區,14134,4332,18466,1553,20019,39950,50.11%,35.38%
0,第7案,臺南市新市區,11296,3511,14807,1203,16010,30386,52.69%,37.18%
0,第7案,臺南市安定區,9675,2801,12476,1199,13675,26104,52.39%,37.06%
0,第7案,臺南市山上區,1960,542,2502,264,2766,6511,42.48%,30.1%
0,第7案,臺南市玉井區,4278,1046,5324,470,5794,12357,46.89%,34.62%
0,第7案,臺南市楠西區,2647,696,3343,312,3655,8528,42.86%,31.04%
0,第7案,臺南市南化區,2581,694,3275,343,3618,7786,46.47%,33.15%
0,第7案,臺南市左鎮區,1315,348,1663,246,1909,4418,43.21%,29.76%
0,第7案,臺南市仁德區,24241,6852,31093,2493,33586,64632,51.96%,37.51%
0,第7案,臺南市歸仁區,21131,6313,27444,2191,29635,57387,51.64%,36.82%
0,第7案,臺南市關廟區,11016,3138,14154,1190,15344,29913,51.3%,36.83%
0,第7案,臺南市龍崎區,1201,330,1531,164,1695,3713,45.65%,32.35%
0,第7案,臺南市永康區,73031,20165,93196,6228,99424,195001,50.99%,37.45%
0,第7案,臺南市東區,59256,18165,77421,5127,82548,153359,53.83%,38.64%
0,第7案,臺南市南區,37899,11973,49872,4423,54295,108650,49.97%,34.88%
0,第7案,臺南市北區,41806,12882,54688,3681,58369,110906,52.63%,37.69%
0,第7案,臺南市安南區,58644,17005,75649,6515,82164,159654,51.46%,36.73%
0,第7案,臺南市安平區,19987,5922,25909,1649,27558,55379,49.76%,36.09%
0,第7案,臺南市中西區,24805,8210,33015,2651,35666,65261,54.65%,38.01%
0,第7案,高雄市,990802,272337,1263139,92579,1355718,2353342,57.61%,42.1%
0,第7案,高雄市鹽埕區,8437,2797,11234,652,11886,21617,54.98%,39.03%
0,第7案,高雄市鼓山區,49511,13531,63042,3914,66956,114979,58.23%,43.06%
0,第7案,高雄市左營區,73230,18003,91233,5165,96398,161367,59.74%,45.38%
0,第7案,高雄市楠梓區,66374,17502,83876,7019,90895,153132,59.36%,43.34%
0,第7案,高雄市三民區,121925,35486,157411,10419,167830,289519,57.97%,42.11%
0,第7案,高雄市新興區,18956,5836,24792,1698,26490,44355,59.72%,42.74%
0,第7案,高雄市前金區,10022,3181,13203,900,14103,23928,58.94%,41.88%
0,第7案,高雄市苓雅區,62964,18917,81881,5252,87133,146786,59.36%,42.9%
0,第7案,高雄市前鎮區,66683,18986,85669,7156,92825,161797,57.37%,41.21%
0,第7案,高雄市旗津區,8332,2706,11038,1261,12299,24860,49.47%,33.52%
0,第7案,高雄市小港區,55974,15327,71301,4956,76257,132733,57.45%,42.17%
0,第7案,高雄市鳳山區,130829,33944,164773,11240,176013,300510,58.57%,43.54%
0,第7案,高雄市林園區,23394,6249,29643,2480,32123,59129,54.33%,39.56%
0,第7案,高雄市大寮區,40259,10438,50697,3833,54530,97309,56.04%,41.37%
0,第7案,高雄市大樹區,14634,3834,18468,1480,19948,36772,54.25%,39.8%
0,第7案,高雄市大社區,11644,3867,15511,1271,16782,30046,55.85%,38.75%
0,第7案,高雄市仁武區,31665,8127,39792,2375,42167,73611,57.28%,43.02%
0,第7案,高雄市鳥松區,16980,4996,21976,1467,23443,39191,59.82%,43.33%
0,第7案,高雄市岡山區,37008,9109,46117,3112,49229,81244,60.59%,45.55%
0,第7案,高雄市橋頭區,14112,4123,18235,1669,19904,32565,61.12%,43.33%
0,第7案,高雄市燕巢區,10583,2759,13342,1259,14601,26012,56.13%,40.69%
0,第7案,高雄市田寮區,2119,621,2740,340,3080,6671,46.17%,31.76%
0,第7案,高雄市阿蓮區,9426,2614,12040,871,12911,24534,52.62%,38.42%
0,第7案,高雄市路竹區,18361,5165,23526,1997,25523,43850,58.21%,41.87%
0,第7案,高雄市湖內區,10110,2791,12901,967,13868,25729,53.9%,39.29%
0,第7案,高雄市茄萣區,9361,3019,12380,1344,13724,26212,52.36%,35.71%
0,第7案,高雄市永安區,5315,1565,6880,606,7486,12001,62.38%,44.29%
0,第7案,高雄市彌陀區,7027,1965,8992,1060,10052,16487,60.97%,42.62%
0,第7案,高雄市梓官區,12760,3460,16220,1448,17668,31025,56.95%,41.13%
0,第7案,高雄市旗山區,12737,3373,16110,1400,17510,31996,54.73%,39.81%
0,第7案,高雄市美濃區,13876,3588,17464,1617,19081,35311,54.04%,39.3%
0,第7案,高雄市六龜區,3692,1075,4767,621,5388,11501,46.85%,32.1%
0,第7案,高雄市甲仙區,1893,444,2337,260,2597,5417,47.94%,34.95%
0,第7案,高雄市杉林區,3301,981,4282,451,4733,10607,44.62%,31.12%
0,第7案,高雄市內門區,4181,1233,5414,697,6111,13002,47%,32.16%
0,第7案,高雄市茂林區,809,166,975,79,1054,1615,65.26%,50.09%
0,第7案,高雄市桃源區,1339,305,1644,99,1743,3498,49.83%,38.28%
0,第7案,高雄市那瑪夏區,979,254,1233,144,1377,2424,56.81%,40.39%
0,第7案,新竹縣,191602,45444,237046,12685,249731,445051,56.11%,43.05%
0,第7案,新竹縣竹北市,61066,15029,76095,3506,79601,137129,58.05%,44.53%
0,第7案,新竹縣竹東鎮,32641,7500,40141,2098,42239,78794,53.61%,41.43%
0,第7案,新竹縣新埔鎮,12327,2899,15226,971,16197,28894,56.06%,42.66%
0,第7案,新竹縣關西鎮,10714,2451,13165,803,13968,24712,56.52%,43.36%
0,第7案,新竹縣湖口鄉,27505,6227,33732,1748,35480,63511,55.86%,43.31%
0,第7案,新竹縣新豐鄉,19499,4612,24111,1385,25496,45790,55.68%,42.58%
0,第7案,新竹縣芎林鄉,7631,1895,9526,592,10118,17293,58.51%,44.13%
0,第7案,新竹縣橫山鄉,5073,1166,6239,430,6669,11346,58.78%,44.71%
0,第7案,新竹縣北埔鄉,3535,782,4317,227,4544,8180,55.55%,43.22%
0,第7案,新竹縣寶山鄉,5773,1417,7190,398,7588,12973,58.49%,44.5%
0,第7案,新竹縣峨眉鄉,2238,570,2808,242,3050,5068,60.18%,44.16%
0,第7案,新竹縣尖石鄉,2358,565,2923,210,3133,7364,42.54%,32.02%
0,第7案,新竹縣五峰鄉,1242,331,1573,75,1648,3997,41.23%,31.07%
0,第7案,苗栗縣,198009,47324,245333,15647,260980,461580,56.54%,42.9%
0,第7案,苗栗縣苗栗市,33815,7069,40884,1931,42815,74249,57.66%,45.54%
0,第7案,苗栗縣苑裡鎮,15998,4451,20449,1621,22070,38890,56.75%,41.14%
0,第7案,苗栗縣通霄鎮,11314,3282,14596,1351,15947,29709,53.68%,38.08%
0,第7案,苗栗縣竹南鎮,29221,6996,36217,2120,38337,68528,55.94%,42.64%
0,第7案,苗栗縣頭份市,36143,8496,44639,2330,46969,83617,56.17%,43.22%
0,第7案,苗栗縣後龍鎮,12288,3270,15558,1426,16984,30948,54.88%,39.71%
0,第7案,苗栗縣卓蘭鎮,6482,1521,8003,538,8541,14772,57.82%,43.88%
0,第7案,苗栗縣大湖鄉,5128,1137,6265,458,6723,12653,53.13%,40.53%
0,第7案,苗栗縣公館鄉,12634,3027,15661,1054,16715,28318,59.03%,44.61%
0,第7案,苗栗縣銅鑼鄉,6726,1472,8198,444,8642,15424,56.03%,43.61%
0,第7案,苗栗縣南庄鄉,3104,893,3997,311,4308,8784,49.04%,35.34%
0,第7案,苗栗縣頭屋鄉,4766,1012,5778,308,6086,9390,64.81%,50.76%
0,第7案,苗栗縣三義鄉,6388,1334,7722,413,8135,13889,58.57%,45.99%
0,第7案,苗栗縣西湖鄉,2724,617,3341,184,3525,6382,55.23%,42.68%
0,第7案,苗栗縣造橋鄉,4744,1156,5900,515,6415,11027,58.18%,43.02%
0,第7案,苗栗縣三灣鄉,2464,651,3115,260,3375,5852,57.67%,42.11%
0,第7案,苗栗縣獅潭鄉,1552,324,1876,143,2019,3968,50.88%,39.11%
0,第7案,苗栗縣泰安鄉,2518,616,3134,240,3374,5180,65.14%,48.61%
0,第7案,彰化縣,452334,111030,563364,45223,608587,1066994,57.04%,42.39%
0,第7案,彰化縣彰化市,85910,21752,107662,7322,114984,190995,60.2%,44.98%
0,第7案,彰化縣鹿港鎮,30219,7228,37447,3228,40675,70505,57.69%,42.86%
0,第7案,彰化縣和美鎮,32445,7579,40024,2554,42578,75286,56.56%,43.1%
0,第7案,彰化縣線西鄉,6361,1367,7728,637,8365,14065,59.47%,45.23%
0,第7案,彰化縣伸港鄉,13300,2650,15950,1254,17204,30407,56.58%,43.74%
0,第7案,彰化縣福興鄉,15627,3996,19623,1927,21550,39745,54.22%,39.32%
0,第7案,彰化縣秀水鄉,14290,3569,17859,1289,19148,32394,59.11%,44.11%
0,第7案,彰化縣花壇鄉,16953,4059,21012,1692,22704,38924,58.33%,43.55%
0,第7案,彰化縣芬園鄉,8346,1976,10322,960,11282,20408,55.28%,40.9%
0,第7案,彰化縣員林市,43129,10985,54114,3431,57545,102028,56.4%,42.27%
0,第7案,彰化縣溪湖鎮,19566,4696,24262,1832,26094,45147,57.8%,43.34%
0,第7案,彰化縣田中鎮,14996,3604,18600,1687,20287,35391,57.32%,42.37%
0,第7案,彰化縣大村鄉,13893,3300,17193,1265,18458,31492,58.61%,44.12%
0,第7案,彰化縣埔鹽鄉,12676,2865,15541,1323,16864,28026,60.17%,45.23%
0,第7案,彰化縣埔心鄉,13153,3544,16697,1503,18200,29642,61.4%,44.37%
0,第7案,彰化縣永靖鄉,13632,3376,17008,1436,18444,31239,59.04%,43.64%
0,第7案,彰化縣社頭鄉,15452,3889,19341,1416,20757,36306,57.17%,42.56%
0,第7案,彰化縣二水鄉,5683,1607,7290,694,7984,13339,59.85%,42.6%
0,第7案,彰化縣北斗鎮,11915,2859,14774,1294,16068,27593,58.23%,43.18%
0,第7案,彰化縣二林鎮,16535,3868,20403,1952,22355,42976,52.02%,38.47%
0,第7案,彰化縣田尾鄉,10126,2487,12613,1014,13627,23179,58.79%,43.69%
0,第7案,彰化縣埤頭鄉,9819,2728,12547,1343,13890,25677,54.1%,38.24%
0,第7案,彰化縣芳苑鄉,10149,2400,12549,1685,14234,29291,48.6%,34.65%
0,第7案,彰化縣大城鄉,4053,953,5006,598,5604,14713,38.09%,27.55%
0,第7案,彰化縣竹塘鄉,4837,1264,6101,710,6811,12821,53.12%,37.73%
0,第7案,彰化縣溪州鄉,9269,2429,11698,1177,12875,25405,50.68%,36.48%
0,第7案,南投縣,187162,41641,228803,15881,244684,427089,57.29%,43.82%
0,第7案,南投縣南投市,39753,8588,48341,2677,51018,84328,60.5%,47.14%
0,第7案,南投縣埔里鎮,30711,6093,36804,2423,39227,68763,57.05%,44.66%
0,第7案,南投縣草屯鎮,37026,8133,45159,2518,47677,82922,57.5%,44.65%
0,第7案,南投縣竹山鎮,18659,5202,23861,1821,25682,47034,54.6%,39.67%
0,第7案,南投縣集集鎮,4068,1045,5113,418,5531,9611,57.55%,42.33%
0,第7案,南投縣名間鄉,14946,3387,18333,1622,19955,33408,59.73%,44.74%
0,第7案,南投縣鹿谷鄉,6543,1383,7926,587,8513,15941,53.4%,41.05%
0,第7案,南投縣中寮鄉,5701,1272,6973,633,7606,13181,57.7%,43.25%
0,第7案,南投縣魚池鄉,5746,1277,7023,536,7559,13958,54.16%,41.17%
0,第7案,南投縣國姓鄉,7165,1490,8655,629,9284,16597,55.94%,43.17%
0,第7案,南投縣水里鄉,6511,1422,7933,589,8522,15458,55.13%,42.12%
0,第7案,南投縣信義鄉,5246,1259,6505,961,7466,13299,56.14%,39.45%
0,第7案,南投縣仁愛鄉,5087,1090,6177,467,6644,12589,52.78%,40.41%
0,第7案,雲林縣,213508,57394,270902,26295,297197,584480,50.85%,36.53%
0,第7案,雲林縣斗六市,38874,9361,48235,2719,50954,89761,56.77%,43.31%
0,第7案,雲林縣斗南鎮,15804,4072,19876,1529,21405,38138,56.13%,41.44%
0,第7案,雲林縣虎尾鎮,22521,5890,28411,2061,30472,58167,52.39%,38.72%
0,第7案,雲林縣西螺鎮,14318,3797,18115,1780,19895,38142,52.16%,37.54%
0,第7案,雲林縣土庫鎮,8902,2454,11356,1302,12658,24412,51.85%,36.47%
0,第7案,雲林縣北港鎮,12837,3548,16385,1884,18269,33958,53.8%,37.8%
0,第7案,雲林縣古坑鄉,10321,2757,13078,1145,14223,27477,51.76%,37.56%
0,第7案,雲林縣大埤鄉,5988,1651,7639,738,8377,16509,50.74%,36.27%
0,第7案,雲林縣莿桐鄉,9304,2727,12031,1428,13459,24570,54.78%,37.87%
0,第7案,雲林縣林內鄉,6202,1601,7803,942,8745,15551,56.23%,39.88%
0,第7案,雲林縣二崙鄉,7403,2281,9684,1247,10931,23367,46.78%,31.68%
0,第7案,雲林縣崙背鄉,6925,2106,9031,970,10001,21050,47.51%,32.9%
0,第7案,雲林縣麥寮鄉,12437,3759,16196,1781,17977,37119,48.43%,33.51%
0,第7案,雲林縣東勢鄉,4542,1181,5723,742,6465,13239,48.83%,34.31%
0,第7案,雲林縣褒忠鄉,4069,1127,5196,511,5707,11381,50.14%,35.75%
0,第7案,雲林縣臺西鄉,6679,1728,8407,1093,9500,21125,44.97%,31.62%
0,第7案,雲林縣元長鄉,6583,1928,8511,1043,9554,22830,41.85%,28.83%
0,第7案,雲林縣四湖鄉,5552,1552,7104,889,7993,20983,38.09%,26.46%
0,第7案,雲林縣口湖鄉,7648,2080,9728,1405,11133,24193,46.02%,31.61%
0,第7案,雲林縣水林鄉,6599,1794,8393,1086,9479,22508,42.11%,29.32%
0,第7案,嘉義縣,155084,42921,198005,21707,219712,442775,49.62%,35.03%
0,第7案,嘉義縣太保市,11773,3217,14990,1411,16401,31568,51.95%,37.29%
0,第7案,嘉義縣朴子市,12753,3455,16208,1714,17922,35191,50.93%,36.24%
0,第7案,嘉義縣布袋鎮,7992,2087,10079,1337,11416,23965,47.64%,33.35%
0,第7案,嘉義縣大林鎮,9837,2605,12442,1126,13568,26922,50.4%,36.54%
0,第7案,嘉義縣民雄鄉,22895,6700,29595,2904,32499,61209,53.1%,37.4%
0,第7案,嘉義縣溪口鄉,4446,1304,5750,716,6466,13105,49.34%,33.93%
0,第7案,嘉義縣新港鄉,9871,2914,12785,1636,14421,27342,52.74%,36.1%
0,第7案,嘉義縣六腳鄉,5958,1540,7498,959,8457,20821,40.62%,28.62%
0,第7案,嘉義縣東石鄉,5735,1576,7311,1164,8475,21915,38.67%,26.17%
0,第7案,嘉義縣義竹鄉,5818,1526,7344,901,8245,16647,49.53%,34.95%
0,第7案,嘉義縣鹿草鄉,4397,1220,5617,904,6521,13937,46.79%,31.55%
0,第7案,嘉義縣水上鄉,16150,4702,20852,2000,22852,43857,52.11%,36.82%
0,第7案,嘉義縣中埔鄉,12785,3594,16379,1538,17917,39139,45.78%,32.67%
0,第7案,嘉義縣竹崎鄉,11147,3039,14186,1393,15579,31228,49.89%,35.7%
0,第7案,嘉義縣梅山鄉,6588,1785,8373,882,9255,17083,54.18%,38.56%
0,第7案,嘉義縣番路鄉,4089,968,5057,508,5565,10156,54.8%,40.26%
0,第7案,嘉義縣大埔鄉,1555,392,1947,167,2114,3999,52.86%,38.88%
0,第7案,嘉義縣阿里山鄉,1295,297,1592,447,2039,4691,43.47%,27.61%
0,第7案,屏東縣,259443,70573,330016,33128,363144,711720,51.02%,36.45%
0,第7案,屏東縣屏東市,66120,17114,83234,5603,88837,170148,52.21%,38.86%
0,第7案,屏東縣潮州鎮,17240,4550,21790,1878,23668,46444,50.96%,37.12%
0,第7案,屏東縣東港鎮,14549,3955,18504,2301,20805,39495,52.68%,36.84%
0,第7案,屏東縣恆春鎮,8909,2055,10964,842,11806,25661,46.01%,34.72%
0,第7案,屏東縣萬丹鄉,15892,4655,20547,2197,22744,43478,52.31%,36.55%
0,第7案,屏東縣長治鄉,9969,2844,12813,1489,14302,26256,54.47%,37.97%
0,第7案,屏東縣麟洛鄉,4077,1077,5154,408,5562,9970,55.79%,40.89%
0,第7案,屏東縣九如鄉,7108,1976,9084,1227,10311,19132,53.89%,37.15%
0,第7案,屏東縣里港鄉,8226,2453,10679,1363,12042,22128,54.42%,37.17%
0,第7案,屏東縣鹽埔鄉,8036,2168,10204,1173,11377,22402,50.79%,35.87%
0,第7案,屏東縣高樹鄉,6898,2226,9124,1225,10349,21697,47.7%,31.79%
0,第7案,屏東縣萬巒鄉,6002,1899,7901,986,8887,17945,49.52%,33.45%
0,第7案,屏東縣內埔鄉,15808,4258,20066,1854,21920,47558,46.09%,33.24%
0,第7案,屏東縣竹田鄉,6113,1793,7906,867,8773,15353,57.14%,39.82%
0,第7案,屏東縣新埤鄉,3096,909,4005,465,4470,9033,49.49%,34.27%
0,第7案,屏東縣枋寮鄉,7667,2168,9835,1370,11205,21394,52.37%,35.84%
0,第7案,屏東縣新園鄉,10874,3150,14024,1928,15952,30706,51.95%,35.41%
0,第7案,屏東縣崁頂鄉,4496,1231,5727,563,6290,12270,51.26%,36.64%
0,第7案,屏東縣林邊鄉,5897,1721,7618,991,8609,15691,54.87%,37.58%
0,第7案,屏東縣南州鄉,3479,966,4445,493,4938,9479,52.09%,36.7%
0,第7案,屏東縣佳冬鄉,5700,1644,7344,1050,8394,17063,49.19%,33.41%
0,第7案,屏東縣琉球鄉,3306,726,4032,551,4583,10706,42.81%,30.88%
0,第7案,屏東縣車城鄉,2167,580,2747,279,3026,7595,39.84%,28.53%
0,第7案,屏東縣滿州鄉,2211,556,2767,240,3007,7206,41.73%,30.68%
0,第7案,屏東縣枋山鄉,1689,484,2173,236,2409,4856,49.61%,34.78%
0,第7案,屏東縣三地門鄉,2295,606,2901,279,3180,6373,49.9%,36.01%
0,第7案,屏東縣霧臺鄉,1151,301,1452,109,1561,2950,52.92%,39.02%
0,第7案,屏東縣瑪家鄉,2394,657,3051,223,3274,5663,57.81%,42.27%
0,第7案,屏東縣泰武鄉,1895,515,2410,287,2697,4344,62.09%,43.62%
0,第7案,屏東縣來義鄉,2655,554,3209,362,3571,6257,57.07%,42.43%
0,第7案,屏東縣春日鄉,767,215,982,56,1038,3923,26.46%,19.55%
0,第7案,屏東縣獅子鄉,1409,287,1696,129,1825,4230,43.14%,33.31%
0,第7案,屏東縣牡丹鄉,1348,280,1628,104,1732,4314,40.15%,31.25%
0,第7案,宜蘭縣,153113,42257,195370,16537,211907,386089,54.89%,39.66%
0,第7案,宜蘭縣宜蘭市,32624,8812,41436,3035,44471,79167,56.17%,41.21%
0,第7案,宜蘭縣羅東鎮,24091,6724,30815,2259,33074,57686,57.33%,41.76%
0,第7案,宜蘭縣蘇澳鎮,13719,3778,17497,1713,19210,34512,55.66%,39.75%
0,第7案,宜蘭縣頭城鎮,9800,2648,12448,1309,13757,25135,54.73%,38.99%
0,第7案,宜蘭縣礁溪鄉,11862,3428,15290,1265,16555,31084,53.26%,38.16%
0,第7案,宜蘭縣壯圍鄉,8549,2410,10959,1263,12222,21447,56.99%,39.86%
0,第7案,宜蘭縣員山鄉,10584,2958,13542,1477,15019,28131,53.39%,37.62%
0,第7案,宜蘭縣冬山鄉,17752,4886,22638,1528,24166,45405,53.22%,39.1%
0,第7案,宜蘭縣五結鄉,13493,3720,17213,1321,18534,34892,53.12%,38.67%
0,第7案,宜蘭縣三星鄉,6988,2021,9009,924,9933,19051,52.14%,36.68%
0,第7案,宜蘭縣大同鄉,1644,443,2087,240,2327,4935,47.15%,33.31%
0,第7案,宜蘭縣南澳鄉,2007,429,2436,203,2639,4644,56.83%,43.22%
0,第7案,花蓮縣,108373,25734,134107,10391,144498,278059,51.97%,38.97%
0,第7案,花蓮縣花蓮市,35174,7825,42999,2424,45423,84807,53.56%,41.48%
0,第7案,花蓮縣鳳林鎮,3909,897,4806,493,5299,9676,54.76%,40.4%
0,第7案,花蓮縣玉里鎮,6862,1752,8614,1061,9675,20650,46.85%,33.23%
0,第7案,花蓮縣新城鄉,6963,1575,8538,621,9159,17029,53.78%,40.89%
0,第7案,花蓮縣吉安鄉,29187,6603,35790,2064,37854,72116,52.49%,40.47%
0,第7案,花蓮縣壽豐鄉,6262,1724,7986,746,8732,15847,55.1%,39.52%
0,第7案,花蓮縣光復鄉,4079,1077,5156,659,5815,11417,50.93%,35.73%
0,第7案,花蓮縣豐濱鄉,1236,386,1622,276,1898,4395,43.19%,28.12%
0,第7案,花蓮縣瑞穗鄉,3616,910,4526,493,5019,10279,48.83%,35.18%
0,第7案,花蓮縣富里鄉,2909,736,3645,470,4115,9065,45.39%,32.09%
0,第7案,花蓮縣秀林鄉,4415,1109,5524,477,6001,12562,47.77%,35.15%
0,第7案,花蓮縣萬榮鄉,1872,625,2497,331,2828,5269,53.67%,35.53%
0,第7案,花蓮縣卓溪鄉,1889,515,2404,276,2680,4947,54.17%,38.18%
0,第7案,臺東縣,67881,17418,85299,8509,93808,185996,50.44%,36.5%
0,第7案,臺東縣臺東市,35634,8420,44054,3184,47238,87803,53.8%,40.58%
0,第7案,臺東縣成功鎮,4157,1106,5263,802,6065,12426,48.81%,33.45%
0,第7案,臺東縣關山鎮,2816,631,3447,232,3679,7509,48.99%,37.5%
0,第7案,臺東縣卑南鄉,5493,1478,6971,819,7790,14976,52.02%,36.68%
0,第7案,臺東縣鹿野鄉,2114,674,2788,299,3087,6936,44.51%,30.48%
0,第7案,臺東縣池上鄉,2353,585,2938,311,3249,7162,45.36%,32.85%
0,第7案,臺東縣東河鄉,2149,636,2785,421,3206,7635,41.99%,28.15%
0,第7案,臺東縣長濱鄉,1686,496,2182,409,2591,6484,39.96%,26%
0,第7案,臺東縣太麻里鄉,3129,898,4027,521,4548,9666,47.05%,32.37%
0,第7案,臺東縣大武鄉,1658,485,2143,528,2671,5266,50.72%,31.48%
0,第7案,臺東縣綠島鄉,1183,276,1459,90,1549,3579,43.28%,33.05%
0,第7案,臺東縣海端鄉,1151,383,1534,197,1731,3278,52.81%,35.11%
0,第7案,臺東縣延平鄉,1008,311,1319,190,1509,2930,51.5%,34.4%
0,第7案,臺東縣金峰鄉,1090,318,1408,205,1613,3028,53.27%,36%
0,第7案,臺東縣達仁鄉,1240,337,1577,188,1765,3137,56.26%,39.53%
0,第7案,臺東縣蘭嶼鄉,1020,384,1404,113,1517,4181,36.28%,24.4%
0,第7案,澎湖縣,29508,7117,36625,3289,39914,90405,44.15%,32.64%
0,第7案,澎湖縣馬公市,19408,4608,24016,1799,25815,53655,48.11%,36.17%
0,第7案,澎湖縣湖西鄉,3956,930,4886,459,5345,12741,41.95%,31.05%
0,第7案,澎湖縣白沙鄉,2535,688,3223,366,3589,8625,41.61%,29.39%
0,第7案,澎湖縣西嶼鄉,1641,409,2050,367,2417,7382,32.74%,22.23%
0,第7案,澎湖縣望安鄉,1256,302,1558,196,1754,4628,37.9%,27.14%
0,第7案,澎湖縣七美鄉,712,180,892,102,994,3374,29.46%,21.1%
0,第7案,金門縣,35436,6045,41481,2336,43817,122695,35.71%,28.88%
0,第7案,金門縣金城鎮,10725,1824,12549,634,13183,37815,34.86%,28.36%
0,第7案,金門縣金沙鎮,5261,868,6129,431,6560,18560,35.34%,28.35%
0,第7案,金門縣金湖鎮,7615,1324,8939,545,9484,25915,36.6%,29.38%
0,第7案,金門縣金寧鄉,8151,1507,9658,503,10161,28162,36.08%,28.94%
0,第7案,金門縣烈嶼鄉,3546,506,4052,212,4264,11676,36.52%,30.37%
0,第7案,金門縣烏坵鄉,138,16,154,11,165,567,29.1%,24.34%
0,第7案,連江縣,4843,655,5498,235,5733,11205,51.16%,43.22%
0,第7案,連江縣南竿鄉,2773,367,3140,133,3273,6461,50.66%,42.92%
0,第7案,連江縣北竿鄉,914,141,1055,47,1102,2125,51.86%,43.01%
0,第7案,連江縣莒光鄉,644,95,739,40,779,1481,52.6%,43.48%
0,第7案,連江縣東引鄉,512,52,564,15,579,1138,50.88%,44.99%
0,第7案,基隆市,121863,31714,153577,9450,163027,320030,50.94%,38.08%
0,第7案,基隆市中正區,15640,4183,19823,1380,21203,45545,46.55%,34.34%
0,第7案,基隆市七堵區,17808,4870,22678,1506,24184,46256,52.28%,38.5%
0,第7案,基隆市暖暖區,13090,3210,16300,842,17142,33225,51.59%,39.4%
0,第7案,基隆市仁愛區,14062,3933,17995,1508,19503,36738,53.09%,38.28%
0,第7案,基隆市中山區,15400,4324,19724,1228,20952,41856,50.06%,36.79%
0,第7案,基隆市安樂區,27453,6944,34397,1844,36241,70396,51.48%,39%
0,第7案,基隆市信義區,18410,4250,22660,1142,23802,46014,51.73%,40.01%
0,第7案,新竹市,147391,39438,186829,9769,196598,351775,55.89%,41.9%
0,第7案,新竹市東區,69070,19030,88100,4123,92223,163757,56.32%,42.18%
0,第7案,新竹市北區,50916,13514,64430,3673,68103,123122,55.31%,41.35%
0,第7案,新竹市香山區,27405,6894,34299,1973,36272,64896,55.89%,42.23%
0,第7案,嘉義市,86276,24205,110481,7639,118120,221553,53.31%,38.94%
0,第7案,嘉義市東區,39258,11159,50417,3338,53755,100647,53.41%,39.01%
0,第7案,嘉義市西區,47018,13046,60064,4301,64365,120906,53.24%,38.89%
0,第8案,全國,7599267,2346316,9945583,823945,10769528,19757067,54.51%,38.46%
0,第8案,臺北市,892660,295984,1188644,86198,1274842,2228430,57.21%,40.06%
0,第8案,臺北市松山區,70346,22879,93225,6471,99696,169278,58.89%,41.56%
0,第8案,臺北市信義區,77960,24430,102390,6933,109323,190444,57.4%,40.94%
0,第8案,臺北市大安區,101321,33964,135285,8129,143414,252645,56.77%,40.1%
0,第8案,臺北市中山區,75659,27107,102766,7777,110543,195148,56.65%,38.77%
0,第8案,臺北市中正區,51892,17351,69243,4648,73891,128292,57.6%,40.45%
0,第8案,臺北市大同區,40451,16258,56709,5064,61773,107557,57.43%,37.61%
0,第8案,臺北市萬華區,61941,21093,83034,7357,90391,164020,55.11%,37.76%
0,第8案,臺北市文山區,98167,28002,126169,8977,135146,227211,59.48%,43.21%
0,第8案,臺北市南港區,41696,13143,54839,3544,58383,101907,57.29%,40.92%
0,第8案,臺北市內湖區,97954,30319,128273,7966,136239,236824,57.53%,41.36%
0,第8案,臺北市士林區,92720,33559,126279,10881,137160,241854,56.71%,38.34%
0,第8案,臺北市北投區,82553,27879,110432,8451,118883,213250,55.75%,38.71%
0,第8案,新北市,1300337,403443,1703780,142560,1846340,3375513,54.7%,38.52%
0,第8案,新北市板橋區,176926,59047,235973,21774,257747,463411,55.62%,38.18%
0,第8案,新北市三重區,122219,42907,165126,18008,183134,329846,55.52%,37.05%
0,第8案,新北市中和區,142856,39619,182475,13264,195739,355978,54.99%,40.13%
0,第8案,新北市永和區,80629,22072,102701,7080,109781,187798,58.46%,42.93%
0,第8案,新北市新莊區,134468,44611,179079,15707,194786,344981,56.46%,38.98%
0,第8案,新北市新店區,111123,28106,139229,9000,148229,264053,56.14%,42.08%
0,第8案,新北市樹林區,57950,18893,76843,6359,83202,152102,54.7%,38.1%
0,第8案,新北市鶯歌區,26086,8489,34575,2638,37213,71645,51.94%,36.41%
0,第8案,新北市三峽區,35036,10500,45536,3548,49084,94291,52.06%,37.16%
0,第8案,新北市淡水區,55441,16540,71981,4862,76843,147272,52.18%,37.65%
0,第8案,新北市汐止區,65487,19406,84893,6318,91211,173831,52.47%,37.67%
0,第8案,新北市瑞芳區,11838,3585,15423,1369,16792,35036,47.93%,33.79%
0,第8案,新北市土城區,76760,24004,100764,8642,109406,200783,54.49%,38.23%
0,第8案,新北市蘆洲區,60780,20753,81533,7713,89246,167457,53.29%,36.3%
0,第8案,新北市五股區,26234,8658,34892,3268,38160,72443,52.68%,36.21%
0,第8案,新北市泰山區,24980,7590,32570,2522,35092,64252,54.62%,38.88%
0,第8案,新北市林口區,34725,10463,45188,2983,48171,86203,55.88%,40.28%
0,第8案,新北市深坑區,7992,2416,10408,793,11201,20624,54.31%,38.75%
0,第8案,新北市石碇區,2232,829,3061,329,3390,6861,49.41%,32.53%
0,第8案,新北市坪林區,1957,618,2575,356,2931,5891,49.75%,33.22%
0,第8案,新北市三芝區,6742,2135,8877,788,9665,20119,48.04%,33.51%
0,第8案,新北市石門區,3696,1170,4866,563,5429,10528,51.57%,35.11%
0,第8案,新北市八里區,11981,3941,15922,1485,17407,32970,52.8%,36.34%
0,第8案,新北市平溪區,1333,447,1780,245,2025,4321,46.86%,30.85%
0,第8案,新北市雙溪區,2599,814,3413,440,3853,7999,48.17%,32.49%
0,第8案,新北市貢寮區,3171,1167,4338,466,4804,11279,42.59%,28.11%
0,第8案,新北市金山區,6535,2082,8617,943,9560,18978,50.37%,34.43%
0,第8案,新北市萬里區,6579,2039,8618,914,9532,19297,49.4%,34.09%
0,第8案,新北市烏來區,1982,542,2524,183,2707,5264,51.42%,37.65%
0,第8案,桃園市,669790,192616,862406,57577,919983,1801823,51.06%,37.17%
0,第8案,桃園市桃園區,130494,39403,169897,10996,180893,359790,50.28%,36.27%
0,第8案,桃園市中壢區,130138,34651,164789,10142,174931,334402,52.31%,38.92%
0,第8案,桃園市大溪區,28638,8815,37453,3444,40897,78285,52.24%,36.58%
0,第8案,桃園市楊梅區,51985,13752,65737,3973,69710,137917,50.54%,37.69%
0,第8案,桃園市蘆竹區,46150,14602,60752,4314,65066,129252,50.34%,35.71%
0,第8案,桃園市大園區,25568,8256,33824,2421,36245,73900,49.05%,34.6%
0,第8案,桃園市龜山區,45663,14542,60205,3969,64174,131702,48.73%,34.67%
0,第8案,桃園市八德區,59933,17095,77028,5780,82808,165065,50.17%,36.31%
0,第8案,桃園市龍潭區,40185,10399,50584,3133,53717,101574,52.88%,39.56%
0,第8案,桃園市平鎮區,71904,18993,90897,5495,96392,183560,52.51%,39.17%
0,第8案,桃園市新屋區,16095,5142,21237,1573,22810,41461,55.02%,38.82%
0,第8案,桃園市觀音區,19477,5998,25475,1935,27410,55149,49.7%,35.32%
0,第8案,桃園市復興區,3560,968,4528,402,4930,9766,50.48%,36.45%
0,第8案,臺中市,950822,273963,1224785,93034,1317819,2295642,57.41%,41.42%
0,第8案,臺中市中區,5704,1769,7473,656,8129,14696,55.31%,38.81%
0,第8案,臺中市東區,26338,8256,34594,2732,37326,64291,58.06%,40.97%
0,第8案,臺中市南區,45430,13472,58902,4366,63268,103643,61.04%,43.83%
0,第8案,臺中市西區,39299,12191,51490,3481,54971,95040,57.84%,41.35%
0,第8案,臺中市北區,50598,14519,65117,4179,69296,124621,55.61%,40.6%
0,第8案,臺中市西屯區,78086,21557,99643,6371,106014,183814,57.67%,42.48%
0,第8案,臺中市南屯區,59274,16840,76114,5177,81291,135448,60.02%,43.76%
0,第8案,臺中市北屯區,95846,25843,121689,7633,129322,227720,56.79%,42.09%
0,第8案,臺中市豐原區,58195,17585,75780,6078,81858,136658,59.9%,42.58%
0,第8案,臺中市東勢區,17561,4978,22539,2316,24855,43181,57.56%,40.67%
0,第8案,臺中市大甲區,25384,7620,33004,3018,36022,63069,57.12%,40.25%
0,第8案,臺中市清水區,29604,8760,38364,3373,41737,71528,58.35%,41.39%
0,第8案,臺中市沙鹿區,29978,8985,38963,2982,41945,74207,56.52%,40.4%
0,第8案,臺中市梧棲區,18726,5879,24605,2163,26768,47040,56.9%,39.81%
0,第8案,臺中市后里區,18679,5157,23836,2124,25960,44962,57.74%,41.54%
0,第8案,臺中市神岡區,22607,6854,29461,2490,31951,54565,58.56%,41.43%
0,第8案,臺中市潭子區,37158,10407,47565,3331,50896,89487,56.88%,41.52%
0,第8案,臺中市大雅區,32177,8781,40958,2890,43848,77189,56.81%,41.69%
0,第8案,臺中市新社區,7705,2101,9806,956,10762,20860,51.59%,36.94%
0,第8案,臺中市石岡區,5359,1555,6914,695,7609,12880,59.08%,41.61%
0,第8案,臺中市外埔區,11290,3099,14389,1294,15683,27059,57.96%,41.72%
0,第8案,臺中市大安區,6763,1921,8684,1010,9694,16520,58.68%,40.94%
0,第8案,臺中市烏日區,25559,7417,32976,2718,35694,61705,57.85%,41.42%
0,第8案,臺中市大肚區,19777,5502,25279,2139,27418,47457,57.77%,41.67%
0,第8案,臺中市龍井區,25170,7724,32894,2476,35370,63584,55.63%,39.59%
0,第8案,臺中市霧峰區,23502,6672,30174,3067,33241,55225,60.19%,42.56%
0,第8案,臺中市太平區,61930,17365,79295,6258,85553,157926,54.17%,39.21%
0,第8案,臺中市大里區,68915,20147,89062,6611,95673,171769,55.7%,40.12%
0,第8案,臺中市和平區,4208,1007,5215,450,5665,9498,59.64%,44.3%
0,第8案,臺南市,541984,188192,730176,67891,798067,1594821,50.04%,33.98%
0,第8案,臺南市新營區,22398,6951,29349,2136,31485,64949,48.48%,34.49%
0,第8案,臺南市鹽水區,6743,2449,9192,1001,10193,22121,46.08%,30.48%
0,第8案,臺南市白河區,6685,2443,9128,1081,10209,24894,41.01%,26.85%
0,第8案,臺南市柳營區,6048,1944,7992,1015,9007,18804,47.9%,32.16%
0,第8案,臺南市後壁區,5961,2055,8016,1231,9247,20841,44.37%,28.6%
0,第8案,臺南市東山區,4312,1513,5825,904,6729,18471,36.43%,23.34%
0,第8案,臺南市麻豆區,12101,4413,16514,1309,17823,37963,46.95%,31.88%
0,第8案,臺南市下營區,6324,2082,8406,1044,9450,20947,45.11%,30.19%
0,第8案,臺南市六甲區,5861,2209,8070,1018,9088,19144,47.47%,30.62%
0,第8案,臺南市官田區,5689,2207,7896,843,8739,18675,46.8%,30.46%
0,第8案,臺南市大內區,2664,835,3499,517,4016,8654,46.41%,30.78%
0,第8案,臺南市佳里區,17798,5733,23531,2249,25780,50407,51.14%,35.31%
0,第8案,臺南市學甲區,7007,2508,9515,926,10441,22567,46.27%,31.05%
0,第8案,臺南市西港區,6716,2122,8838,739,9577,21564,44.41%,31.14%
0,第8案,臺南市七股區,5675,1847,7522,899,8421,19950,42.21%,28.45%
0,第8案,臺南市將軍區,4896,1613,6509,743,7252,17754,40.85%,27.58%
0,第8案,臺南市北門區,2613,829,3442,343,3785,9925,38.14%,26.33%
0,第8案,臺南市新化區,13258,4349,17607,2058,19665,37296,52.73%,35.55%
0,第8案,臺南市善化區,13391,4901,18292,1754,20046,39950,50.18%,33.52%
0,第8案,臺南市新市區,10793,3857,14650,1357,16007,30386,52.68%,35.52%
0,第8案,臺南市安定區,9082,3227,12309,1359,13668,26104,52.36%,34.79%
0,第8案,臺南市山上區,1824,635,2459,302,2761,6511,42.41%,28.01%
0,第8案,臺南市玉井區,4041,1204,5245,549,5794,12357,46.89%,32.7%
0,第8案,臺南市楠西區,2534,745,3279,380,3659,8528,42.91%,29.71%
0,第8案,臺南市南化區,2452,783,3235,377,3612,7786,46.39%,31.49%
0,第8案,臺南市左鎮區,1219,412,1631,280,1911,4418,43.25%,27.59%
0,第8案,臺南市仁德區,23085,7505,30590,2993,33583,64632,51.96%,35.72%
0,第8案,臺南市歸仁區,20119,7113,27232,2388,29620,57387,51.61%,35.06%
0,第8案,臺南市關廟區,10370,3637,14007,1315,15322,29913,51.22%,34.67%
0,第8案,臺南市龍崎區,1137,377,1514,184,1698,3713,45.73%,30.62%
0,第8案,臺南市永康區,69493,22722,92215,7200,99415,195001,50.98%,35.64%
0,第8案,臺南市東區,56699,19840,76539,5810,82349,153359,53.7%,36.97%
0,第8案,臺南市南區,36014,13298,49312,4974,54286,108650,49.96%,33.15%
0,第8案,臺南市北區,39802,14099,53901,4263,58164,110906,52.44%,35.89%
0,第8案,臺南市安南區,54864,19800,74664,7489,82153,159654,51.46%,34.36%
0,第8案,臺南市安平區,19061,6603,25664,1803,27467,55379,49.6%,34.42%
0,第8案,臺南市中西區,23255,9332,32587,3058,35645,65261,54.62%,35.63%
0,第8案,高雄市,944727,307838,1252565,100943,1353508,2353342,57.51%,40.14%
0,第8案,高雄市鹽埕區,8031,3161,11192,705,11897,21617,55.04%,37.15%
0,第8案,高雄市鼓山區,47801,14884,62685,4110,66795,114979,58.09%,41.57%
0,第8案,高雄市左營區,70034,20435,90469,5819,96288,161367,59.67%,43.4%
0,第8案,高雄市楠梓區,63689,19693,83382,7497,90879,153132,59.35%,41.59%
0,第8案,高雄市三民區,116063,39799,155862,11491,167353,289519,57.8%,40.09%
0,第8案,高雄市新興區,17858,6745,24603,1859,26462,44355,59.66%,40.26%
0,第8案,高雄市前金區,9714,3464,13178,953,14131,23928,59.06%,40.6%
0,第8案,高雄市苓雅區,60364,21461,81825,5570,87395,146786,59.54%,41.12%
0,第8案,高雄市前鎮區,63622,21376,84998,7668,92666,161797,57.27%,39.32%
0,第8案,高雄市旗津區,7980,2930,10910,1363,12273,24860,49.37%,32.1%
0,第8案,高雄市小港區,53331,17489,70820,5365,76185,132733,57.4%,40.18%
0,第8案,高雄市鳳山區,125228,38044,163272,12418,175690,300510,58.46%,41.67%
0,第8案,高雄市林園區,21562,7309,28871,2647,31518,59129,53.3%,36.47%
0,第8案,高雄市大寮區,38152,12176,50328,4102,54430,97309,55.94%,39.21%
0,第8案,高雄市大樹區,13775,4495,18270,1662,19932,36772,54.2%,37.46%
0,第8案,高雄市大社區,11407,4150,15557,1432,16989,30046,56.54%,37.97%
0,第8案,高雄市仁武區,30136,9368,39504,2644,42148,73611,57.26%,40.94%
0,第8案,高雄市鳥松區,16185,5680,21865,1588,23453,39191,59.84%,41.3%
0,第8案,高雄市岡山區,35021,10410,45431,3363,48794,81244,60.06%,43.11%
0,第8案,高雄市橋頭區,13387,4597,17984,1877,19861,32565,60.99%,41.11%
0,第8案,高雄市燕巢區,9937,3265,13202,1399,14601,26012,56.13%,38.2%
0,第8案,高雄市田寮區,1969,745,2714,366,3080,6671,46.17%,29.52%
0,第8案,高雄市阿蓮區,8896,3061,11957,944,12901,24534,52.58%,36.26%
0,第8案,高雄市路竹區,17563,5709,23272,2274,25546,43850,58.26%,40.05%
0,第8案,高雄市湖內區,9563,3311,12874,1074,13948,25729,54.21%,37.17%
0,第8案,高雄市茄萣區,8933,3368,12301,1321,13622,26212,51.97%,34.08%
0,第8案,高雄市永安區,4954,1826,6780,691,7471,12001,62.25%,41.28%
0,第8案,高雄市彌陀區,6672,2280,8952,1100,10052,16487,60.97%,40.47%
0,第8案,高雄市梓官區,11955,4135,16090,1564,17654,31025,56.9%,38.53%
0,第8案,高雄市旗山區,11993,3911,15904,1580,17484,31996,54.64%,37.48%
0,第8案,高雄市美濃區,13355,3817,17172,1861,19033,35311,53.9%,37.82%
0,第8案,高雄市六龜區,3583,1077,4660,737,5397,11501,46.93%,31.15%
0,第8案,高雄市甲仙區,1786,515,2301,296,2597,5417,47.94%,32.97%
0,第8案,高雄市杉林區,3178,1039,4217,508,4725,10607,44.55%,29.96%
0,第8案,高雄市內門區,4045,1307,5352,732,6084,13002,46.79%,31.11%
0,第8案,高雄市茂林區,784,183,967,91,1058,1615,65.51%,48.54%
0,第8案,高雄市桃源區,1284,348,1632,112,1744,3498,49.86%,36.71%
0,第8案,高雄市那瑪夏區,937,275,1212,160,1372,2424,56.6%,38.66%
0,第8案,新竹縣,183636,50494,234130,15306,249436,445051,56.05%,41.26%
0,第8案,新竹縣竹北市,58887,16366,75253,4168,79421,137129,57.92%,42.94%
0,第8案,新竹縣竹東鎮,31275,8381,39656,2551,42207,78794,53.57%,39.69%
0,第8案,新竹縣新埔鎮,11786,3223,15009,1170,16179,28894,55.99%,40.79%
0,第8案,新竹縣關西鎮,10240,2754,12994,966,13960,24712,56.49%,41.44%
0,第8案,新竹縣湖口鄉,26304,7039,33343,2124,35467,63511,55.84%,41.42%
0,第8案,新竹縣新豐鄉,18567,5228,23795,1691,25486,45790,55.66%,40.55%
0,第8案,新竹縣芎林鄉,7308,2084,9392,721,10113,17293,58.48%,42.26%
0,第8案,新竹縣橫山鄉,4816,1321,6137,536,6673,11346,58.81%,42.45%
0,第8案,新竹縣北埔鄉,3310,931,4241,297,4538,8180,55.48%,40.46%
0,第8案,新竹縣寶山鄉,5520,1553,7073,491,7564,12973,58.31%,42.55%
0,第8案,新竹縣峨眉鄉,2134,612,2746,302,3048,5068,60.14%,42.11%
0,第8案,新竹縣尖石鄉,2272,655,2927,202,3129,7364,42.49%,30.85%
0,第8案,新竹縣五峰鄉,1217,347,1564,87,1651,3997,41.31%,30.45%
0,第8案,苗栗縣,188547,53465,242012,19013,261025,461580,56.55%,40.85%
0,第8案,苗栗縣苗栗市,32286,8001,40287,2503,42790,74249,57.63%,43.48%
0,第8案,苗栗縣苑裡鎮,14932,5203,20135,1912,22047,38890,56.69%,38.4%
0,第8案,苗栗縣通霄鎮,10444,3914,14358,1525,15883,29709,53.46%,35.15%
0,第8案,苗栗縣竹南鎮,28011,7800,35811,2497,38308,68528,55.9%,40.88%
0,第8案,苗栗縣頭份市,34955,9243,44198,2893,47091,83617,56.32%,41.8%
0,第8案,苗栗縣後龍鎮,11546,3888,15434,1628,17062,30948,55.13%,37.31%
0,第8案,苗栗縣卓蘭鎮,6104,1799,7903,650,8553,14772,57.9%,41.32%
0,第8案,苗栗縣大湖鄉,4829,1347,6176,566,6742,12653,53.28%,38.16%
0,第8案,苗栗縣公館鄉,11979,3364,15343,1361,16704,28318,58.99%,42.3%
0,第8案,苗栗縣銅鑼鄉,6444,1608,8052,584,8636,15424,55.99%,41.78%
0,第8案,苗栗縣南庄鄉,3033,885,3918,386,4304,8784,49%,34.53%
0,第8案,苗栗縣頭屋鄉,4533,1161,5694,392,6086,9390,64.81%,48.27%
0,第8案,苗栗縣三義鄉,6123,1538,7661,471,8132,13889,58.55%,44.09%
0,第8案,苗栗縣西湖鄉,2586,661,3247,278,3525,6382,55.23%,40.52%
0,第8案,苗栗縣造橋鄉,4538,1279,5817,587,6404,11027,58.08%,41.15%
0,第8案,苗栗縣三灣鄉,2335,716,3051,322,3373,5852,57.64%,39.9%
0,第8案,苗栗縣獅潭鄉,1444,370,1814,204,2018,3968,50.86%,36.39%
0,第8案,苗栗縣泰安鄉,2425,688,3113,254,3367,5180,65%,46.81%
0,第8案,彰化縣,427390,128963,556353,52105,608458,1066994,57.03%,40.06%
0,第8案,彰化縣彰化市,81200,25213,106413,8530,114943,190995,60.18%,42.51%
0,第8案,彰化縣鹿港鎮,28359,8531,36890,3742,40632,70505,57.63%,40.22%
0,第8案,彰化縣和美鎮,30448,9110,39558,3001,42559,75286,56.53%,40.44%
0,第8案,彰化縣線西鄉,5907,1723,7630,746,8376,14065,59.55%,42%
0,第8案,彰化縣伸港鄉,12385,3334,15719,1434,17153,30407,56.41%,40.73%
0,第8案,彰化縣福興鄉,14835,4407,19242,2147,21389,39745,53.82%,37.33%
0,第8案,彰化縣秀水鄉,13411,4221,17632,1516,19148,32394,59.11%,41.4%
0,第8案,彰化縣花壇鄉,15558,5026,20584,1998,22582,38924,58.02%,39.97%
0,第8案,彰化縣芬園鄉,7792,2316,10108,1147,11255,20408,55.15%,38.18%
0,第8案,彰化縣員林市,41186,12364,53550,3952,57502,102028,56.36%,40.37%
0,第8案,彰化縣溪湖鎮,18816,5155,23971,2109,26080,45147,57.77%,41.68%
0,第8案,彰化縣田中鎮,14080,4422,18502,1855,20357,35391,57.52%,39.78%
0,第8案,彰化縣大村鄉,13152,3807,16959,1477,18436,31492,58.54%,41.76%
0,第8案,彰化縣埔鹽鄉,11850,3486,15336,1527,16863,28026,60.17%,42.28%
0,第8案,彰化縣埔心鄉,12457,4053,16510,1667,18177,29642,61.32%,42.02%
0,第8案,彰化縣永靖鄉,12889,3845,16734,1690,18424,31239,58.98%,41.26%
0,第8案,彰化縣社頭鄉,14676,4415,19091,1643,20734,36306,57.11%,40.42%
0,第8案,彰化縣二水鄉,5356,1784,7140,840,7980,13339,59.82%,40.15%
0,第8案,彰化縣北斗鎮,11209,3312,14521,1520,16041,27593,58.13%,40.62%
0,第8案,彰化縣二林鎮,15723,4767,20490,2296,22786,42976,53.02%,36.59%
0,第8案,彰化縣田尾鄉,9787,2791,12578,1147,13725,23179,59.21%,42.22%
0,第8案,彰化縣埤頭鄉,9625,2777,12402,1486,13888,25677,54.09%,37.48%
0,第8案,彰化縣芳苑鄉,9529,2813,12342,1818,14160,29291,48.34%,32.53%
0,第8案,彰化縣大城鄉,3820,1117,4937,662,5599,14713,38.05%,25.96%
0,第8案,彰化縣竹塘鄉,4516,1489,6005,817,6822,12821,53.21%,35.22%
0,第8案,彰化縣溪州鄉,8824,2685,11509,1338,12847,25405,50.57%,34.73%
0,第8案,南投縣,178821,46683,225504,19043,244547,427089,57.26%,41.87%
0,第8案,南投縣南投市,37773,9552,47325,3247,50572,84328,59.97%,44.79%
0,第8案,南投縣埔里鎮,29379,7062,36441,2913,39354,68763,57.23%,42.73%
0,第8案,南投縣草屯鎮,35497,9226,44723,3042,47765,82922,57.6%,42.81%
0,第8案,南投縣竹山鎮,18263,5289,23552,2222,25774,47034,54.8%,38.83%
0,第8案,南投縣集集鎮,4010,1023,5033,502,5535,9611,57.59%,41.72%
0,第8案,南投縣名間鄉,14224,3820,18044,1911,19955,33408,59.73%,42.58%
0,第8案,南投縣鹿谷鄉,6191,1574,7765,737,8502,15941,53.33%,38.84%
0,第8案,南投縣中寮鄉,5299,1549,6848,746,7594,13181,57.61%,40.2%
0,第8案,南投縣魚池鄉,5418,1488,6906,657,7563,13958,54.18%,38.82%
0,第8案,南投縣國姓鄉,6621,1861,8482,802,9284,16597,55.94%,39.89%
0,第8案,南投縣水里鄉,6115,1728,7843,674,8517,15458,55.1%,39.56%
0,第8案,南投縣信義鄉,5078,1353,6431,1055,7486,13299,56.29%,38.18%
0,第8案,南投縣仁愛鄉,4953,1158,6111,535,6646,12589,52.79%,39.34%
0,第8案,雲林縣,201784,65207,266991,30111,297102,584480,50.83%,34.52%
0,第8案,雲林縣斗六市,37013,10854,47867,3212,51079,89761,56.91%,41.24%
0,第8案,雲林縣斗南鎮,14869,4663,19532,1803,21335,38138,55.94%,38.99%
0,第8案,雲林縣虎尾鎮,21498,6641,28139,2288,30427,58167,52.31%,36.96%
0,第8案,雲林縣西螺鎮,13352,4447,17799,2186,19985,38142,52.4%,35.01%
0,第8案,雲林縣土庫鎮,8329,2817,11146,1490,12636,24412,51.76%,34.12%
0,第8案,雲林縣北港鎮,12097,4026,16123,2146,18269,33958,53.8%,35.62%
0,第8案,雲林縣古坑鄉,9830,3001,12831,1389,14220,27477,51.75%,35.78%
0,第8案,雲林縣大埤鄉,5714,1835,7549,848,8397,16509,50.86%,34.61%
0,第8案,雲林縣莿桐鄉,8735,3012,11747,1614,13361,24570,54.38%,35.55%
0,第8案,雲林縣林內鄉,5852,1805,7657,1072,8729,15551,56.13%,37.63%
0,第8案,雲林縣二崙鄉,7014,2497,9511,1410,10921,23367,46.74%,30.02%
0,第8案,雲林縣崙背鄉,6625,2318,8943,1083,10026,21050,47.63%,31.47%
0,第8案,雲林縣麥寮鄉,11823,4152,15975,1967,17942,37119,48.34%,31.85%
0,第8案,雲林縣東勢鄉,4190,1419,5609,843,6452,13239,48.73%,31.65%
0,第8案,雲林縣褒忠鄉,3862,1292,5154,541,5695,11381,50.04%,33.93%
0,第8案,雲林縣臺西鄉,6272,1982,8254,1231,9485,21125,44.9%,29.69%
0,第8案,雲林縣元長鄉,6174,2194,8368,1185,9553,22830,41.84%,27.04%
0,第8案,雲林縣四湖鄉,5233,1748,6981,1011,7992,20983,38.09%,24.94%
0,第8案,雲林縣口湖鄉,7192,2367,9559,1578,11137,24193,46.03%,29.73%
0,第8案,雲林縣水林鄉,6110,2137,8247,1214,9461,22508,42.03%,27.15%
0,第8案,嘉義縣,145827,49345,195172,24257,219429,442775,49.56%,32.93%
0,第8案,嘉義縣太保市,10962,3836,14798,1601,16399,31568,51.95%,34.73%
0,第8案,嘉義縣朴子市,12009,3835,15844,2053,17897,35191,50.86%,34.13%
0,第8案,嘉義縣布袋鎮,7385,2490,9875,1525,11400,23965,47.57%,30.82%
0,第8案,嘉義縣大林鎮,9111,3032,12143,1408,13551,26922,50.33%,33.84%
0,第8案,嘉義縣民雄鄉,21538,7626,29164,3313,32477,61209,53.06%,35.19%
0,第8案,嘉義縣溪口鄉,4125,1455,5580,875,6455,13105,49.26%,31.48%
0,第8案,嘉義縣新港鄉,9189,3294,12483,1935,14418,27342,52.73%,33.61%
0,第8案,嘉義縣六腳鄉,5473,1859,7332,1019,8351,20821,40.11%,26.29%
0,第8案,嘉義縣東石鄉,5381,1864,7245,1233,8478,21915,38.69%,24.55%
0,第8案,嘉義縣義竹鄉,5431,1796,7227,1014,8241,16647,49.5%,32.62%
0,第8案,嘉義縣鹿草鄉,4098,1349,5447,1042,6489,13937,46.56%,29.4%
0,第8案,嘉義縣水上鄉,15249,5407,20656,2205,22861,43857,52.13%,34.77%
0,第8案,嘉義縣中埔鄉,12092,4090,16182,1719,17901,39139,45.74%,30.9%
0,第8案,嘉義縣竹崎鄉,10700,3474,14174,1401,15575,31228,49.88%,34.26%
0,第8案,嘉義縣梅山鄉,6169,2019,8188,1035,9223,17083,53.99%,36.11%
0,第8案,嘉義縣番路鄉,3888,1102,4990,569,5559,10156,54.74%,38.28%
0,第8案,嘉義縣大埔鄉,1488,448,1936,177,2113,3999,52.84%,37.21%
0,第8案,嘉義縣阿里山鄉,1539,369,1908,133,2041,4691,43.51%,32.81%
0,第8案,屏東縣,245566,79966,325532,37095,362627,711720,50.95%,34.5%
0,第8案,屏東縣屏東市,63176,19070,82246,6383,88629,170148,52.09%,37.13%
0,第8案,屏東縣潮州鎮,16580,5151,21731,2123,23854,46444,51.36%,35.7%
0,第8案,屏東縣東港鎮,13572,4579,18151,2671,20822,39495,52.72%,34.36%
0,第8案,屏東縣恆春鎮,8345,2490,10835,982,11817,25661,46.05%,32.52%
0,第8案,屏東縣萬丹鄉,14920,5311,20231,2511,22742,43478,52.31%,34.32%
0,第8案,屏東縣長治鄉,9433,3174,12607,1667,14274,26256,54.36%,35.93%
0,第8案,屏東縣麟洛鄉,3838,1289,5127,451,5578,9970,55.95%,38.5%
0,第8案,屏東縣九如鄉,6601,2369,8970,1357,10327,19132,53.98%,34.5%
0,第8案,屏東縣里港鄉,7701,2799,10500,1576,12076,22128,54.57%,34.8%
0,第8案,屏東縣鹽埔鄉,7560,2514,10074,1294,11368,22402,50.75%,33.75%
0,第8案,屏東縣高樹鄉,6482,2513,8995,1308,10303,21697,47.49%,29.88%
0,第8案,屏東縣萬巒鄉,5697,2105,7802,1120,8922,17945,49.72%,31.75%
0,第8案,屏東縣內埔鄉,14890,4816,19706,2111,21817,47558,45.87%,31.31%
0,第8案,屏東縣竹田鄉,5777,2046,7823,962,8785,15353,57.22%,37.63%
0,第8案,屏東縣新埤鄉,2880,990,3870,548,4418,9033,48.91%,31.88%
0,第8案,屏東縣枋寮鄉,7292,2451,9743,1469,11212,21394,52.41%,34.08%
0,第8案,屏東縣新園鄉,10269,3577,13846,2072,15918,30706,51.84%,33.44%
0,第8案,屏東縣崁頂鄉,4227,1400,5627,649,6276,12270,51.15%,34.45%
0,第8案,屏東縣林邊鄉,5553,1908,7461,1108,8569,15691,54.61%,35.39%
0,第8案,屏東縣南州鄉,3279,1098,4377,555,4932,9479,52.03%,34.59%
0,第8案,屏東縣佳冬鄉,5317,1854,7171,1101,8272,17063,48.48%,31.16%
0,第8案,屏東縣琉球鄉,2962,827,3789,602,4391,10706,41.01%,27.67%
0,第8案,屏東縣車城鄉,2023,694,2717,306,3023,7595,39.8%,26.64%
0,第8案,屏東縣滿州鄉,2123,663,2786,255,3041,7206,42.2%,29.46%
0,第8案,屏東縣枋山鄉,1616,530,2146,256,2402,4856,49.46%,33.28%
0,第8案,屏東縣三地門鄉,2208,644,2852,320,3172,6373,49.77%,34.65%
0,第8案,屏東縣霧臺鄉,1106,340,1446,112,1558,2950,52.81%,37.49%
0,第8案,屏東縣瑪家鄉,2346,681,3027,252,3279,5663,57.9%,41.43%
0,第8案,屏東縣泰武鄉,1791,580,2371,325,2696,4344,62.06%,41.23%
0,第8案,屏東縣來義鄉,2576,642,3218,349,3567,6257,57.01%,41.17%
0,第8案,屏東縣春日鄉,739,233,972,61,1033,3923,26.33%,18.84%
0,第8案,屏東縣獅子鄉,1382,314,1696,127,1823,4230,43.1%,32.67%
0,第8案,屏東縣牡丹鄉,1305,314,1619,112,1731,4314,40.13%,30.25%
0,第8案,宜蘭縣,148910,43259,192169,19570,211739,386089,54.84%,38.57%
0,第8案,宜蘭縣宜蘭市,32163,8747,40910,3586,44496,79167,56.21%,40.63%
0,第8案,宜蘭縣羅東鎮,23361,6884,30245,2814,33059,57686,57.31%,40.5%
0,第8案,宜蘭縣蘇澳鎮,13182,4065,17247,2029,19276,34512,55.85%,38.2%
0,第8案,宜蘭縣頭城鎮,9390,2823,12213,1535,13748,25135,54.7%,37.36%
0,第8案,宜蘭縣礁溪鄉,11552,3510,15062,1503,16565,31084,53.29%,37.16%
0,第8案,宜蘭縣壯圍鄉,8149,2591,10740,1453,12193,21447,56.85%,38%
0,第8案,宜蘭縣員山鄉,10219,3058,13277,1740,15017,28131,53.38%,36.33%
0,第8案,宜蘭縣冬山鄉,17407,4801,22208,1804,24012,45405,52.88%,38.34%
0,第8案,宜蘭縣五結鄉,13195,3768,16963,1577,18540,34892,53.14%,37.82%
0,第8案,宜蘭縣三星鄉,6724,2119,8843,1029,9872,19051,51.82%,35.29%
0,第8案,宜蘭縣大同鄉,1581,471,2052,273,2325,4935,47.11%,32.04%
0,第8案,宜蘭縣南澳鄉,1987,422,2409,227,2636,4644,56.76%,42.79%
0,第8案,花蓮縣,104153,28095,132248,12163,144411,278059,51.94%,37.46%
0,第8案,花蓮縣花蓮市,33828,8590,42418,2948,45366,84807,53.49%,39.89%
0,第8案,花蓮縣鳳林鎮,3783,934,4717,573,5290,9676,54.67%,39.1%
0,第8案,花蓮縣玉里鎮,6519,1916,8435,1232,9667,20650,46.81%,31.57%
0,第8案,花蓮縣新城鄉,6668,1798,8466,699,9165,17029,53.82%,39.16%
0,第8案,花蓮縣吉安鄉,28209,7124,35333,2515,37848,72116,52.48%,39.12%
0,第8案,花蓮縣壽豐鄉,5963,1879,7842,882,8724,15847,55.05%,37.63%
0,第8案,花蓮縣光復鄉,3925,1155,5080,738,5818,11417,50.96%,34.38%
0,第8案,花蓮縣豐濱鄉,1172,403,1575,314,1889,4395,42.98%,26.67%
0,第8案,花蓮縣瑞穗鄉,3429,1006,4435,576,5011,10279,48.75%,33.36%
0,第8案,花蓮縣富里鄉,2782,822,3604,509,4113,9065,45.37%,30.69%
0,第8案,花蓮縣秀林鄉,4254,1246,5500,518,6018,12562,47.91%,33.86%
0,第8案,花蓮縣萬榮鄉,1802,667,2469,355,2824,5269,53.6%,34.2%
0,第8案,花蓮縣卓溪鄉,1819,555,2374,304,2678,4947,54.13%,36.77%
0,第8案,臺東縣,65521,18824,84345,9356,93701,185996,50.38%,35.23%
0,第8案,臺東縣臺東市,34531,9173,43704,3501,47205,87803,53.76%,39.33%
0,第8案,臺東縣成功鎮,4010,1193,5203,869,6072,12426,48.87%,32.27%
0,第8案,臺東縣關山鎮,2662,701,3363,313,3676,7509,48.95%,35.45%
0,第8案,臺東縣卑南鄉,5255,1631,6886,835,7721,14976,51.56%,35.09%
0,第8案,臺東縣鹿野鄉,2011,727,2738,343,3081,6936,44.42%,28.99%
0,第8案,臺東縣池上鄉,2209,673,2882,362,3244,7162,45.29%,30.84%
0,第8案,臺東縣東河鄉,2087,663,2750,463,3213,7635,42.08%,27.33%
0,第8案,臺東縣長濱鄉,1590,511,2101,484,2585,6484,39.87%,24.52%
0,第8案,臺東縣太麻里鄉,2997,971,3968,569,4537,9666,46.94%,31.01%
0,第8案,臺東縣大武鄉,1577,542,2119,555,2674,5266,50.78%,29.95%
0,第8案,臺東縣綠島鄉,1147,300,1447,101,1548,3579,43.25%,32.05%
0,第8案,臺東縣海端鄉,1129,391,1520,212,1732,3278,52.84%,34.44%
0,第8案,臺東縣延平鄉,974,337,1311,199,1510,2930,51.54%,33.24%
0,第8案,臺東縣金峰鄉,1060,340,1400,212,1612,3028,53.24%,35.01%
0,第8案,臺東縣達仁鄉,1291,270,1561,198,1759,3137,56.07%,41.15%
0,第8案,臺東縣蘭嶼鄉,991,401,1392,140,1532,4181,36.64%,23.7%
0,第8案,澎湖縣,28232,7910,36142,3599,39741,90405,43.96%,31.23%
0,第8案,澎湖縣馬公市,18487,5114,23601,1997,25598,53655,47.71%,34.46%
0,第8案,澎湖縣湖西鄉,3825,1035,4860,485,5345,12741,41.95%,30.02%
0,第8案,澎湖縣白沙鄉,2443,756,3199,389,3588,8625,41.6%,28.32%
0,第8案,澎湖縣西嶼鄉,1618,461,2079,382,2461,7382,33.34%,21.92%
0,第8案,澎湖縣望安鄉,1192,333,1525,232,1757,4628,37.96%,25.76%
0,第8案,澎湖縣七美鄉,667,211,878,114,992,3374,29.4%,19.77%
0,第8案,金門縣,34139,6816,40955,2945,43900,122695,35.78%,27.82%
0,第8案,金門縣金城鎮,10346,2034,12380,812,13192,37815,34.89%,27.36%
0,第8案,金門縣金沙鎮,5095,960,6055,505,6560,18560,35.34%,27.45%
0,第8案,金門縣金湖鎮,7443,1448,8891,688,9579,25915,36.96%,28.72%
0,第8案,金門縣金寧鄉,7708,1798,9506,651,10157,28162,36.07%,27.37%
0,第8案,金門縣烈嶼鄉,3412,556,3968,279,4247,11676,36.37%,29.22%
0,第8案,金門縣烏坵鄉,135,20,155,10,165,567,29.1%,23.81%
0,第8案,連江縣,4705,769,5474,257,5731,11205,51.15%,41.99%
0,第8案,連江縣南竿鄉,2708,425,3133,139,3272,6461,50.64%,41.91%
0,第8案,連江縣北竿鄉,903,142,1045,59,1104,2125,51.95%,42.49%
0,第8案,連江縣莒光鄉,610,124,734,43,777,1481,52.46%,41.19%
0,第8案,連江縣東引鄉,484,78,562,16,578,1138,50.79%,42.53%
0,第8案,基隆市,118570,33570,152140,10546,162686,320030,50.83%,37.05%
0,第8案,基隆市中正區,15275,4267,19542,1538,21080,45545,46.28%,33.54%
0,第8案,基隆市七堵區,17242,5289,22531,1698,24229,46256,52.38%,37.28%
0,第8案,基隆市暖暖區,12703,3527,16230,893,17123,33225,51.54%,38.23%
0,第8案,基隆市仁愛區,13573,4225,17798,1682,19480,36738,53.02%,36.95%
0,第8案,基隆市中山區,14924,4550,19474,1463,20937,41856,50.02%,35.66%
0,第8案,基隆市安樂區,26895,7380,34275,1970,36245,70396,51.49%,38.21%
0,第8案,基隆市信義區,17958,4332,22290,1302,23592,46014,51.27%,39.03%
0,第8案,新竹市,141640,43061,184701,11576,196277,351775,55.8%,40.26%
0,第8案,新竹市東區,66631,20584,87215,4981,92196,163757,56.3%,40.69%
0,第8案,新竹市北區,48668,14935,63603,4266,67869,123122,55.12%,39.53%
0,第8案,新竹市香山區,26341,7542,33883,2329,36212,64896,55.8%,40.59%
0,第8案,嘉義市,81506,27853,109359,8800,118159,221553,53.33%,36.79%
0,第8案,嘉義市東區,37194,12843,50037,3705,53742,100647,53.4%,36.95%
0,第8案,嘉義市西區,44312,15010,59322,5095,64417,120906,53.28%,36.65%
0,第9案,全國,7791856,2231425,10023281,756041,10779322,19757067,54.56%,39.44%
0,第9案,臺北市,922395,279844,1202239,74941,1277180,2228430,57.31%,41.39%
0,第9案,臺北市松山區,72672,21614,94286,5549,99835,169278,58.98%,42.93%
0,第9案,臺北市信義區,80252,22789,103041,6057,109098,190444,57.29%,42.14%
0,第9案,臺北市大安區,105524,31885,137409,7116,144525,252645,57.2%,41.77%
0,第9案,臺北市中山區,78403,25525,103928,6836,110764,195148,56.76%,40.18%
0,第9案,臺北市中正區,54214,16318,70532,3896,74428,128292,58.01%,42.26%
0,第9案,臺北市大同區,42181,15060,57241,4408,61649,107557,57.32%,39.22%
0,第9案,臺北市萬華區,63881,20023,83904,6601,90505,164020,55.18%,38.95%
0,第9案,臺北市文山區,100344,26928,127272,7692,134964,227211,59.4%,44.16%
0,第9案,臺北市南港區,42721,12523,55244,3123,58367,101907,57.27%,41.92%
0,第9案,臺北市內湖區,101210,28795,130005,6798,136803,236824,57.77%,42.74%
0,第9案,臺北市士林區,95594,32145,127739,9355,137094,241854,56.68%,39.53%
0,第9案,臺北市北投區,85399,26239,111638,7510,119148,213250,55.87%,40.05%
0,第9案,新北市,1338359,382433,1720792,127605,1848397,3375513,54.76%,39.65%
0,第9案,新北市板橋區,183906,55619,239525,18834,258359,463411,55.75%,39.69%
0,第9案,新北市三重區,126943,40687,167630,15951,183581,329846,55.66%,38.49%
0,第9案,新北市中和區,146291,38167,184458,11790,196248,355978,55.13%,41.1%
0,第9案,新北市永和區,82910,20904,103814,6214,110028,187798,58.59%,44.15%
0,第9案,新北市新莊區,139805,40941,180746,14127,194873,344981,56.49%,40.53%
0,第9案,新北市新店區,112489,27746,140235,8099,148334,264053,56.18%,42.6%
0,第9案,新北市樹林區,59598,18134,77732,5540,83272,152102,54.75%,39.18%
0,第9案,新北市鶯歌區,27021,7767,34788,2543,37331,71645,52.11%,37.72%
0,第9案,新北市三峽區,35620,10204,45824,3252,49076,94291,52.05%,37.78%
0,第9案,新北市淡水區,56884,15744,72628,4275,76903,147272,52.22%,38.63%
0,第9案,新北市汐止區,66826,18635,85461,5764,91225,173831,52.48%,38.44%
0,第9案,新北市瑞芳區,11889,3499,15388,1389,16777,35036,47.89%,33.93%
0,第9案,新北市土城區,78444,23052,101496,8032,109528,200783,54.55%,39.07%
0,第9案,新北市蘆洲區,62795,19292,82087,6999,89086,167457,53.2%,37.5%
0,第9案,新北市五股區,27203,8114,35317,2891,38208,72443,52.74%,37.55%
0,第9案,新北市泰山區,25751,7077,32828,2195,35023,64252,54.51%,40.08%
0,第9案,新北市林口區,36130,9352,45482,2631,48113,86203,55.81%,41.91%
0,第9案,新北市深坑區,8138,2354,10492,709,11201,20624,54.31%,39.46%
0,第9案,新北市石碇區,2295,801,3096,305,3401,6861,49.57%,33.45%
0,第9案,新北市坪林區,1953,621,2574,354,2928,5891,49.7%,33.15%
0,第9案,新北市三芝區,6678,2109,8787,749,9536,20119,47.4%,33.19%
0,第9案,新北市石門區,3763,1130,4893,535,5428,10528,51.56%,35.74%
0,第9案,新北市八里區,12479,3635,16114,1313,17427,32970,52.86%,37.85%
0,第9案,新北市平溪區,1356,440,1796,231,2027,4321,46.91%,31.38%
0,第9案,新北市雙溪區,2684,763,3447,415,3862,7999,48.28%,33.55%
0,第9案,新北市貢寮區,3212,1103,4315,491,4806,11279,42.61%,28.48%
0,第9案,新北市金山區,6592,2052,8644,929,9573,18978,50.44%,34.73%
0,第9案,新北市萬里區,6706,1960,8666,881,9547,19297,49.47%,34.75%
0,第9案,新北市烏來區,1998,531,2529,167,2696,5264,51.22%,37.96%
0,第9案,桃園市,688091,178491,866582,53039,919621,1801823,51.04%,38.19%
0,第9案,桃園市桃園區,135146,36154,171300,9713,181013,359790,50.31%,37.56%
0,第9案,桃園市中壢區,133601,31671,165272,9376,174648,334402,52.23%,39.95%
0,第9案,桃園市大溪區,29096,8537,37633,3237,40870,78285,52.21%,37.17%
0,第9案,桃園市楊梅區,52981,12652,65633,3838,69471,137917,50.37%,38.42%
0,第9案,桃園市蘆竹區,47832,13297,61129,3997,65126,129252,50.39%,37.01%
0,第9案,桃園市大園區,26424,7468,33892,2188,36080,73900,48.82%,35.76%
0,第9案,桃園市龜山區,46731,13559,60290,3728,64018,131702,48.61%,35.48%
0,第9案,桃園市八德區,61711,15775,77486,5315,82801,165065,50.16%,37.39%
0,第9案,桃園市龍潭區,40992,9904,50896,2941,53837,101574,53%,40.36%
0,第9案,桃園市平鎮區,73505,18054,91559,4915,96474,183560,52.56%,40.04%
0,第9案,桃園市新屋區,16624,4714,21338,1533,22871,41461,55.16%,40.1%
0,第9案,桃園市觀音區,19925,5698,25623,1844,27467,55149,49.81%,36.13%
0,第9案,桃園市復興區,3523,1008,4531,414,4945,9766,50.63%,36.07%
0,第9案,臺中市,979821,256540,1236361,81945,1318306,2295642,57.43%,42.68%
0,第9案,臺中市中區,5791,1823,7614,526,8140,14696,55.39%,39.41%
0,第9案,臺中市東區,27322,7695,35017,2488,37505,64291,58.34%,42.5%
0,第9案,臺中市南區,46759,12828,59587,3822,63409,103643,61.18%,45.12%
0,第9案,臺中市西區,40385,11765,52150,2891,55041,95040,57.91%,42.49%
0,第9案,臺中市北區,52039,13793,65832,3502,69334,124621,55.64%,41.76%
0,第9案,臺中市西屯區,79926,20371,100297,5642,105939,183814,57.63%,43.48%
0,第9案,臺中市南屯區,60752,16391,77143,4455,81598,135448,60.24%,44.85%
0,第9案,臺中市北屯區,98529,23765,122294,7061,129355,227720,56.8%,43.27%
0,第9案,臺中市豐原區,60188,16041,76229,5127,81356,136658,59.53%,44.04%
0,第9案,臺中市東勢區,18187,4704,22891,2135,25026,43181,57.96%,42.12%
0,第9案,臺中市大甲區,26358,6823,33181,2601,35782,63069,56.73%,41.79%
0,第9案,臺中市清水區,30691,8080,38771,3018,41789,71528,58.42%,42.91%
0,第9案,臺中市沙鹿區,31524,7795,39319,2682,42001,74207,56.6%,42.48%
0,第9案,臺中市梧棲區,19604,5267,24871,1888,26759,47040,56.89%,41.68%
0,第9案,臺中市后里區,18978,5164,24142,1842,25984,44962,57.79%,42.21%
0,第9案,臺中市神岡區,23245,6451,29696,2231,31927,54565,58.51%,42.6%
0,第9案,臺中市潭子區,38184,9737,47921,2886,50807,89487,56.78%,42.67%
0,第9案,臺中市大雅區,33234,7930,41164,2665,43829,77189,56.78%,43.06%
0,第9案,臺中市新社區,8051,2049,10100,760,10860,20860,52.06%,38.6%
0,第9案,臺中市石岡區,5462,1576,7038,585,7623,12880,59.18%,42.41%
0,第9案,臺中市外埔區,11940,2774,14714,1017,15731,27059,58.14%,44.13%
0,第9案,臺中市大安區,6877,1904,8781,907,9688,16520,58.64%,41.63%
0,第9案,臺中市烏日區,26319,7090,33409,2506,35915,61705,58.2%,42.65%
0,第9案,臺中市大肚區,20208,5225,25433,1993,27426,47457,57.79%,42.58%
0,第9案,臺中市龍井區,26267,6958,33225,2229,35454,63584,55.76%,41.31%
0,第9案,臺中市霧峰區,24158,6486,30644,2571,33215,55225,60.14%,43.74%
0,第9案,臺中市太平區,63860,16284,80144,5343,85487,157926,54.13%,40.44%
0,第9案,臺中市大里區,70764,18720,89484,6179,95663,171769,55.69%,41.2%
0,第9案,臺中市和平區,4219,1051,5270,393,5663,9498,59.62%,44.42%
0,第9案,臺南市,560594,178274,738868,60334,799202,1594821,50.11%,35.15%
0,第9案,臺南市新營區,22908,6715,29623,1878,31501,64949,48.5%,35.27%
0,第9案,臺南市鹽水區,6972,2373,9345,886,10231,22121,46.25%,31.52%
0,第9案,臺南市白河區,6981,2370,9351,909,10260,24894,41.21%,28.04%
0,第9案,臺南市柳營區,6152,1934,8086,937,9023,18804,47.98%,32.72%
0,第9案,臺南市後壁區,6290,1929,8219,1046,9265,20841,44.46%,30.18%
0,第9案,臺南市東山區,4446,1557,6003,746,6749,18471,36.54%,24.07%
0,第9案,臺南市麻豆區,12403,4280,16683,1193,17876,37963,47.09%,32.67%
0,第9案,臺南市下營區,6443,2029,8472,969,9441,20947,45.07%,30.76%
0,第9案,臺南市六甲區,6067,2143,8210,895,9105,19144,47.56%,31.69%
0,第9案,臺南市官田區,5969,2099,8068,687,8755,18675,46.88%,31.96%
0,第9案,臺南市大內區,2718,875,3593,429,4022,8654,46.48%,31.41%
0,第9案,臺南市佳里區,18292,5510,23802,1986,25788,50407,51.16%,36.29%
0,第9案,臺南市學甲區,7318,2285,9603,855,10458,22567,46.34%,32.43%
0,第9案,臺南市西港區,6712,2132,8844,761,9605,21564,44.54%,31.13%
0,第9案,臺南市七股區,5754,1890,7644,781,8425,19950,42.23%,28.84%
0,第9案,臺南市將軍區,5072,1558,6630,665,7295,17754,41.09%,28.57%
0,第9案,臺南市北門區,2663,846,3509,292,3801,9925,38.3%,26.83%
0,第9案,臺南市新化區,13548,4320,17868,1826,19694,37296,52.8%,36.33%
0,第9案,臺南市善化區,13857,4592,18449,1620,20069,39950,50.24%,34.69%
0,第9案,臺南市新市區,11298,3479,14777,1250,16027,30386,52.74%,37.18%
0,第9案,臺南市安定區,9470,2944,12414,1263,13677,26104,52.39%,36.28%
0,第9案,臺南市山上區,1873,609,2482,275,2757,6511,42.34%,28.77%
0,第9案,臺南市玉井區,4104,1186,5290,505,5795,12357,46.9%,33.21%
0,第9案,臺南市楠西區,2572,744,3316,341,3657,8528,42.88%,30.16%
0,第9案,臺南市南化區,2456,808,3264,355,3619,7786,46.48%,31.54%
0,第9案,臺南市左鎮區,1234,439,1673,231,1904,4418,43.1%,27.93%
0,第9案,臺南市仁德區,24009,7048,31057,2573,33630,64632,52.03%,37.15%
0,第9案,臺南市歸仁區,20762,6557,27319,2338,29657,57387,51.68%,36.18%
0,第9案,臺南市關廟區,10607,3519,14126,1243,15369,29913,51.38%,35.46%
0,第9案,臺南市龍崎區,1191,348,1539,160,1699,3713,45.76%,32.08%
0,第9案,臺南市永康區,71529,21293,92822,6646,99468,195001,51.01%,36.68%
0,第9案,臺南市東區,58738,18683,77421,4959,82380,153359,53.72%,38.3%
0,第9案,臺南市南區,37203,12765,49968,4367,54335,108650,50.01%,34.24%
0,第9案,臺南市北區,41607,13080,54687,3729,58416,110906,52.67%,37.52%
0,第9案,臺南市安南區,57329,18271,75600,6561,82161,159654,51.46%,35.91%
0,第9案,臺南市安平區,19673,6250,25923,1661,27584,55379,49.81%,35.52%
0,第9案,臺南市中西區,24374,8814,33188,2516,35704,65261,54.71%,37.35%
0,第9案,高雄市,968007,290441,1258448,97698,1356146,2353342,57.63%,41.13%
0,第9案,高雄市鹽埕區,8309,2943,11252,676,11928,21617,55.18%,38.44%
0,第9案,高雄市鼓山區,48707,14112,62819,4086,66905,114979,58.19%,42.36%
0,第9案,高雄市左營區,71184,19573,90757,5424,96181,161367,59.6%,44.11%
0,第9案,高雄市楠梓區,65274,18600,83874,7198,91072,153132,59.47%,42.63%
0,第9案,高雄市三民區,120091,37189,157280,10524,167804,289519,57.96%,41.48%
0,第9案,高雄市新興區,18404,6488,24892,1616,26508,44355,59.76%,41.49%
0,第9案,高雄市前金區,9799,3417,13216,904,14120,23928,59.01%,40.95%
0,第9案,高雄市苓雅區,62255,19545,81800,5685,87485,146786,59.6%,42.41%
0,第9案,高雄市前鎮區,65326,20199,85525,7215,92740,161797,57.32%,40.38%
0,第9案,高雄市旗津區,8132,2910,11042,1324,12366,24860,49.74%,32.71%
0,第9案,高雄市小港區,55215,15762,70977,5177,76154,132733,57.37%,41.6%
0,第9案,高雄市鳳山區,129085,35291,164376,11320,175696,300510,58.47%,42.96%
0,第9案,高雄市林園區,22575,6889,29464,2778,32242,59129,54.53%,38.18%
0,第9案,高雄市大寮區,38925,11430,50355,4150,54505,97309,56.01%,40%
0,第9案,高雄市大樹區,13972,4324,18296,1704,20000,36772,54.39%,38%
0,第9案,高雄市大社區,11744,3908,15652,1396,17048,30046,56.74%,39.09%
0,第9案,高雄市仁武區,30858,8796,39654,2570,42224,73611,57.36%,41.92%
0,第9案,高雄市鳥松區,16620,5282,21902,1550,23452,39191,59.84%,42.41%
0,第9案,高雄市岡山區,35934,9783,45717,3433,49150,81244,60.5%,44.23%
0,第9案,高雄市橋頭區,13650,4323,17973,1929,19902,32565,61.11%,41.92%
0,第9案,高雄市燕巢區,10042,3140,13182,1444,14626,26012,56.23%,38.61%
0,第9案,高雄市田寮區,2021,706,2727,358,3085,6671,46.24%,30.3%
0,第9案,高雄市阿蓮區,9103,2878,11981,954,12935,24534,52.72%,37.1%
0,第9案,高雄市路竹區,17739,5509,23248,2307,25555,43850,58.28%,40.45%
0,第9案,高雄市湖內區,9497,3356,12853,1079,13932,25729,54.15%,36.91%
0,第9案,高雄市茄萣區,9093,3132,12225,1502,13727,26212,52.37%,34.69%
0,第9案,高雄市永安區,5146,1654,6800,682,7482,12001,62.34%,42.88%
0,第9案,高雄市彌陀區,6401,2587,8988,1082,10070,16487,61.08%,38.82%
0,第9案,高雄市梓官區,12179,3914,16093,1582,17675,31025,56.97%,39.26%
0,第9案,高雄市旗山區,12146,3836,15982,1525,17507,31996,54.72%,37.96%
0,第9案,高雄市美濃區,13318,3814,17132,1879,19011,35311,53.84%,37.72%
0,第9案,高雄市六龜區,3496,1226,4722,698,5420,11501,47.13%,30.4%
0,第9案,高雄市甲仙區,1767,518,2285,314,2599,5417,47.98%,32.62%
0,第9案,高雄市杉林區,3088,1137,4225,507,4732,10607,44.61%,29.11%
0,第9案,高雄市內門區,3998,1359,5357,762,6119,13002,47.06%,30.75%
0,第9案,高雄市茂林區,758,213,971,90,1061,1615,65.7%,46.93%
0,第9案,高雄市桃源區,1239,395,1634,109,1743,3498,49.83%,35.42%
0,第9案,高雄市那瑪夏區,917,303,1220,165,1385,2424,57.14%,37.83%
0,第9案,新竹縣,187845,47564,235409,14059,249468,445051,56.05%,42.21%
0,第9案,新竹縣竹北市,60847,14949,75796,3703,79499,137129,57.97%,44.37%
0,第9案,新竹縣竹東鎮,31963,7885,39848,2370,42218,78794,53.58%,40.57%
0,第9案,新竹縣新埔鎮,12046,3055,15101,1093,16194,28894,56.05%,41.69%
0,第9案,新竹縣關西鎮,10235,2748,12983,974,13957,24712,56.48%,41.42%
0,第9案,新竹縣湖口鄉,26766,6632,33398,1932,35330,63511,55.63%,42.14%
0,第9案,新竹縣新豐鄉,19113,4910,24023,1488,25511,45790,55.71%,41.74%
0,第9案,新竹縣芎林鄉,7422,2022,9444,673,10117,17293,58.5%,42.92%
0,第9案,新竹縣橫山鄉,4871,1288,6159,516,6675,11346,58.83%,42.93%
0,第9案,新竹縣北埔鄉,3408,853,4261,284,4545,8180,55.56%,41.66%
0,第9案,新竹縣寶山鄉,5620,1533,7153,431,7584,12973,58.46%,43.32%
0,第9案,新竹縣峨眉鄉,2175,595,2770,279,3049,5068,60.16%,42.92%
0,第9案,新竹縣尖石鄉,2212,713,2925,213,3138,7364,42.61%,30.04%
0,第9案,新竹縣五峰鄉,1167,381,1548,103,1651,3997,41.31%,29.2%
0,第9案,苗栗縣,190918,51594,242512,18483,260995,461580,56.54%,41.36%
0,第9案,苗栗縣苗栗市,33058,7432,40490,2312,42802,74249,57.65%,44.52%
0,第9案,苗栗縣苑裡鎮,15629,4685,20314,1797,22111,38890,56.86%,40.19%
0,第9案,苗栗縣通霄鎮,10767,3578,14345,1550,15895,29709,53.5%,36.24%
0,第9案,苗栗縣竹南鎮,28434,7574,36008,2346,38354,68528,55.97%,41.49%
0,第9案,苗栗縣頭份市,35262,8947,44209,2801,47010,83617,56.22%,42.17%
0,第9案,苗栗縣後龍鎮,11663,3645,15308,1670,16978,30948,54.86%,37.69%
0,第9案,苗栗縣卓蘭鎮,6068,1785,7853,698,8551,14772,57.89%,41.08%
0,第9案,苗栗縣大湖鄉,4826,1340,6166,561,6727,12653,53.17%,38.14%
0,第9案,苗栗縣公館鄉,12057,3320,15377,1336,16713,28318,59.02%,42.58%
0,第9案,苗栗縣銅鑼鄉,6390,1673,8063,577,8640,15424,56.02%,41.43%
0,第9案,苗栗縣南庄鄉,2985,947,3932,376,4308,8784,49.04%,33.98%
0,第9案,苗栗縣頭屋鄉,4274,1432,5706,379,6085,9390,64.8%,45.52%
0,第9案,苗栗縣三義鄉,6215,1468,7683,453,8136,13889,58.58%,44.75%
0,第9案,苗栗縣西湖鄉,2572,703,3275,247,3522,6382,55.19%,40.3%
0,第9案,苗栗縣造橋鄉,4561,1261,5822,591,6413,11027,58.16%,41.36%
0,第9案,苗栗縣三灣鄉,2313,742,3055,320,3375,5852,57.67%,39.52%
0,第9案,苗栗縣獅潭鄉,1450,374,1824,194,2018,3968,50.86%,36.54%
0,第9案,苗栗縣泰安鄉,2394,688,3082,275,3357,5180,64.81%,46.22%
0,第9案,彰化縣,435289,124114,559403,49307,608710,1066994,57.05%,40.8%
0,第9案,彰化縣彰化市,82918,24013,106931,8048,114979,190995,60.2%,43.41%
0,第9案,彰化縣鹿港鎮,29288,7935,37223,3450,40673,70505,57.69%,41.54%
0,第9案,彰化縣和美鎮,31150,8679,39829,2760,42589,75286,56.57%,41.38%
0,第9案,彰化縣線西鄉,5957,1685,7642,722,8364,14065,59.47%,42.35%
0,第9案,彰化縣伸港鄉,12503,3290,15793,1402,17195,30407,56.55%,41.12%
0,第9案,彰化縣福興鄉,14916,4420,19336,2066,21402,39745,53.85%,37.53%
0,第9案,彰化縣秀水鄉,13713,4039,17752,1407,19159,32394,59.14%,42.33%
0,第9案,彰化縣花壇鄉,16349,4652,21001,1751,22752,38924,58.45%,42%
0,第9案,彰化縣芬園鄉,7947,2336,10283,1021,11304,20408,55.39%,38.94%
0,第9案,彰化縣員林市,41981,11756,53737,3746,57483,102028,56.34%,41.15%
0,第9案,彰化縣溪湖鎮,18938,5142,24080,2056,26136,45147,57.89%,41.95%
0,第9案,彰化縣田中鎮,14161,4397,18558,1808,20366,35391,57.55%,40.01%
0,第9案,彰化縣大村鄉,13263,3714,16977,1492,18469,31492,58.65%,42.12%
0,第9案,彰化縣埔鹽鄉,12202,3172,15374,1600,16974,28026,60.57%,43.54%
0,第9案,彰化縣埔心鄉,12765,3760,16525,1644,18169,29642,61.29%,43.06%
0,第9案,彰化縣永靖鄉,13073,3831,16904,1549,18453,31239,59.07%,41.85%
0,第9案,彰化縣社頭鄉,15033,4210,19243,1509,20752,36306,57.16%,41.41%
0,第9案,彰化縣二水鄉,5428,1776,7204,783,7987,13339,59.88%,40.69%
0,第9案,彰化縣北斗鎮,11516,3186,14702,1353,16055,27593,58.19%,41.74%
0,第9案,彰化縣二林鎮,15738,4574,20312,2130,22442,42976,52.22%,36.62%
0,第9案,彰化縣田尾鄉,9767,2733,12500,1114,13614,23179,58.73%,42.14%
0,第9案,彰化縣埤頭鄉,9747,2585,12332,1576,13908,25677,54.17%,37.96%
0,第9案,彰化縣芳苑鄉,9721,2873,12594,1607,14201,29291,48.48%,33.19%
0,第9案,彰化縣大城鄉,3812,1159,4971,633,5604,14713,38.09%,25.91%
0,第9案,彰化縣竹塘鄉,4563,1487,6050,772,6822,12821,53.21%,35.59%
0,第9案,彰化縣溪州鄉,8840,2710,11550,1308,12858,25405,50.61%,34.8%
0,第9案,南投縣,178955,46704,225659,18796,244455,427089,57.24%,41.9%
0,第9案,南投縣南投市,38111,9402,47513,3138,50651,84328,60.06%,45.19%
0,第9案,南投縣埔里鎮,29122,7155,36277,2927,39204,68763,57.01%,42.35%
0,第9案,南投縣草屯鎮,35644,9073,44717,2943,47660,82922,57.48%,42.98%
0,第9案,南投縣竹山鎮,18660,4928,23588,2221,25809,47034,54.87%,39.67%
0,第9案,南投縣集集鎮,3923,1084,5007,526,5533,9611,57.57%,40.82%
0,第9案,南投縣名間鄉,14150,3930,18080,1870,19950,33408,59.72%,42.36%
0,第9案,南投縣鹿谷鄉,6158,1620,7778,737,8515,15941,53.42%,38.63%
0,第9案,南投縣中寮鄉,5406,1473,6879,735,7614,13181,57.76%,41.01%
0,第9案,南投縣魚池鄉,5432,1494,6926,632,7558,13958,54.15%,38.92%
0,第9案,南投縣國姓鄉,6677,1824,8501,784,9285,16597,55.94%,40.23%
0,第9案,南投縣水里鄉,6143,1693,7836,693,8529,15458,55.18%,39.74%
0,第9案,南投縣信義鄉,4802,1623,6425,1071,7496,13299,56.37%,36.11%
0,第9案,南投縣仁愛鄉,4727,1405,6132,519,6651,12589,52.83%,37.55%
0,第9案,雲林縣,205923,61421,267344,29764,297108,584480,50.83%,35.23%
0,第9案,雲林縣斗六市,37857,9790,47647,3219,50866,89761,56.67%,42.18%
0,第9案,雲林縣斗南鎮,15189,4288,19477,1835,21312,38138,55.88%,39.83%
0,第9案,雲林縣虎尾鎮,22054,6123,28177,2270,30447,58167,52.34%,37.91%
0,第9案,雲林縣西螺鎮,13877,4030,17907,2025,19932,38142,52.26%,36.38%
0,第9案,雲林縣土庫鎮,8494,2672,11166,1471,12637,24412,51.77%,34.79%
0,第9案,雲林縣北港鎮,12419,3822,16241,2050,18291,33958,53.86%,36.57%
0,第9案,雲林縣古坑鄉,9837,2928,12765,1454,14219,27477,51.75%,35.8%
0,第9案,雲林縣大埤鄉,5545,2021,7566,839,8405,16509,50.91%,33.59%
0,第9案,雲林縣莿桐鄉,8760,3042,11802,1627,13429,24570,54.66%,35.65%
0,第9案,雲林縣林內鄉,5885,1800,7685,1061,8746,15551,56.24%,37.84%
0,第9案,雲林縣二崙鄉,7059,2495,9554,1370,10924,23367,46.75%,30.21%
0,第9案,雲林縣崙背鄉,6828,2094,8922,1095,10017,21050,47.59%,32.44%
0,第9案,雲林縣麥寮鄉,12612,3512,16124,1876,18000,37119,48.49%,33.98%
0,第9案,雲林縣東勢鄉,4284,1330,5614,843,6457,13239,48.77%,32.36%
0,第9案,雲林縣褒忠鄉,3848,1298,5146,550,5696,11381,50.05%,33.81%
0,第9案,雲林縣臺西鄉,6431,1833,8264,1227,9491,21125,44.93%,30.44%
0,第9案,雲林縣元長鄉,6209,2193,8402,1168,9570,22830,41.92%,27.2%
0,第9案,雲林縣四湖鄉,5308,1658,6966,1030,7996,20983,38.11%,25.3%
0,第9案,雲林縣口湖鄉,7175,2418,9593,1543,11136,24193,46.03%,29.66%
0,第9案,雲林縣水林鄉,6252,2074,8326,1211,9537,22508,42.37%,27.78%
0,第9案,嘉義縣,149984,47427,197411,22181,219592,442775,49.59%,33.87%
0,第9案,嘉義縣太保市,11386,3585,14971,1457,16428,31568,52.04%,36.07%
0,第9案,嘉義縣朴子市,12495,3747,16242,1655,17897,35191,50.86%,35.51%
0,第9案,嘉義縣布袋鎮,7715,2385,10100,1333,11433,23965,47.71%,32.19%
0,第9案,嘉義縣大林鎮,9524,2915,12439,1139,13578,26922,50.43%,35.38%
0,第9案,嘉義縣民雄鄉,22263,7199,29462,3013,32475,61209,53.06%,36.37%
0,第9案,嘉義縣溪口鄉,4264,1472,5736,724,6460,13105,49.29%,32.54%
0,第9案,嘉義縣新港鄉,9650,3135,12785,1652,14437,27342,52.8%,35.29%
0,第9案,嘉義縣六腳鄉,5627,1792,7419,954,8373,20821,40.21%,27.03%
0,第9案,嘉義縣東石鄉,5321,1829,7150,1256,8406,21915,38.36%,24.28%
0,第9案,嘉義縣義竹鄉,5589,1748,7337,920,8257,16647,49.6%,33.57%
0,第9案,嘉義縣鹿草鄉,4178,1371,5549,951,6500,13937,46.64%,29.98%
0,第9案,嘉義縣水上鄉,15484,5157,20641,2221,22862,43857,52.13%,35.31%
0,第9案,嘉義縣中埔鄉,12424,3869,16293,1632,17925,39139,45.8%,31.74%
0,第9案,嘉義縣竹崎鄉,10766,3339,14105,1485,15590,31228,49.92%,34.48%
0,第9案,嘉義縣梅山鄉,6323,1919,8242,1001,9243,17083,54.11%,37.01%
0,第9案,嘉義縣番路鄉,3930,1119,5049,520,5569,10156,54.83%,38.7%
0,第9案,嘉義縣大埔鄉,1505,446,1951,163,2114,3999,52.86%,37.63%
0,第9案,嘉義縣阿里山鄉,1540,400,1940,105,2045,4691,43.59%,32.83%
0,第9案,屏東縣,248756,79806,328562,34063,362625,711720,50.95%,34.95%
0,第9案,屏東縣屏東市,64458,18343,82801,5695,88496,170148,52.01%,37.88%
0,第9案,屏東縣潮州鎮,16646,5232,21878,1897,23775,46444,51.19%,35.84%
0,第9案,屏東縣東港鎮,13808,4617,18425,2364,20789,39495,52.64%,34.96%
0,第9案,屏東縣恆春鎮,8238,2668,10906,894,11800,25661,45.98%,32.1%
0,第9案,屏東縣萬丹鄉,15318,5129,20447,2282,22729,43478,52.28%,35.23%
0,第9案,屏東縣長治鄉,9495,3250,12745,1553,14298,26256,54.46%,36.16%
0,第9案,屏東縣麟洛鄉,3938,1208,5146,423,5569,9970,55.86%,39.5%
0,第9案,屏東縣九如鄉,6789,2253,9042,1276,10318,19132,53.93%,35.49%
0,第9案,屏東縣里港鄉,7828,2811,10639,1417,12056,22128,54.48%,35.38%
0,第9案,屏東縣鹽埔鄉,7682,2584,10266,1126,11392,22402,50.85%,34.29%
0,第9案,屏東縣高樹鄉,6606,2450,9056,1304,10360,21697,47.75%,30.45%
0,第9案,屏東縣萬巒鄉,5851,2028,7879,1026,8905,17945,49.62%,32.61%
0,第9案,屏東縣內埔鄉,15290,4786,20076,1864,21940,47558,46.13%,32.15%
0,第9案,屏東縣竹田鄉,5870,2003,7873,909,8782,15353,57.2%,38.23%
0,第9案,屏東縣新埤鄉,2922,1058,3980,490,4470,9033,49.49%,32.35%
0,第9案,屏東縣枋寮鄉,7274,2544,9818,1418,11236,21394,52.52%,34%
0,第9案,屏東縣新園鄉,10271,3619,13890,1967,15857,30706,51.64%,33.45%
0,第9案,屏東縣崁頂鄉,4264,1436,5700,588,6288,12270,51.25%,34.75%
0,第9案,屏東縣林邊鄉,5595,1994,7589,1007,8596,15691,54.78%,35.66%
0,第9案,屏東縣南州鄉,3287,1090,4377,571,4948,9479,52.2%,34.68%
0,第9案,屏東縣佳冬鄉,5642,1673,7315,1050,8365,17063,49.02%,33.07%
0,第9案,屏東縣琉球鄉,2928,867,3795,552,4347,10706,40.6%,27.35%
0,第9案,屏東縣車城鄉,1997,728,2725,297,3022,7595,39.79%,26.29%
0,第9案,屏東縣滿州鄉,2125,650,2775,219,2994,7206,41.55%,29.49%
0,第9案,屏東縣枋山鄉,1577,577,2154,247,2401,4856,49.44%,32.48%
0,第9案,屏東縣三地門鄉,2114,776,2890,296,3186,6373,49.99%,33.17%
0,第9案,屏東縣霧臺鄉,1077,381,1458,112,1570,2950,53.22%,36.51%
0,第9案,屏東縣瑪家鄉,2264,780,3044,235,3279,5663,57.9%,39.98%
0,第9案,屏東縣泰武鄉,1771,611,2382,318,2700,4344,62.15%,40.77%
0,第9案,屏東縣來義鄉,2515,662,3177,389,3566,6257,56.99%,40.19%
0,第9案,屏東縣春日鄉,719,261,980,48,1028,3923,26.2%,18.33%
0,第9案,屏東縣獅子鄉,1346,367,1713,121,1834,4230,43.36%,31.82%
0,第9案,屏東縣牡丹鄉,1251,370,1621,108,1729,4314,40.08%,29%
0,第9案,宜蘭縣,149047,45210,194257,17663,211920,386089,54.89%,38.6%
0,第9案,宜蘭縣宜蘭市,32123,9145,41268,3184,44452,79167,56.15%,40.58%
0,第9案,宜蘭縣羅東鎮,23633,7130,30763,2324,33087,57686,57.36%,40.97%
0,第9案,宜蘭縣蘇澳鎮,13047,4165,17212,1971,19183,34512,55.58%,37.8%
0,第9案,宜蘭縣頭城鎮,9379,3000,12379,1381,13760,25135,54.74%,37.31%
0,第9案,宜蘭縣礁溪鄉,11637,3652,15289,1324,16613,31084,53.45%,37.44%
0,第9案,宜蘭縣壯圍鄉,8267,2706,10973,1259,12232,21447,57.03%,38.55%
0,第9案,宜蘭縣員山鄉,10227,3218,13445,1551,14996,28131,53.31%,36.35%
0,第9案,宜蘭縣冬山鄉,17337,5095,22432,1730,24162,45405,53.21%,38.18%
0,第9案,宜蘭縣五結鄉,13187,3935,17122,1445,18567,34892,53.21%,37.79%
0,第9案,宜蘭縣三星鄉,6720,2202,8922,991,9913,19051,52.03%,35.27%
0,第9案,宜蘭縣大同鄉,1552,486,2038,285,2323,4935,47.07%,31.45%
0,第9案,宜蘭縣南澳鄉,1938,476,2414,218,2632,4644,56.68%,41.73%
0,第9案,花蓮縣,104326,28174,132500,11987,144487,278059,51.96%,37.52%
0,第9案,花蓮縣花蓮市,34380,8293,42673,2728,45401,84807,53.53%,40.54%
0,第9案,花蓮縣鳳林鎮,3785,953,4738,555,5293,9676,54.7%,39.12%
0,第9案,花蓮縣玉里鎮,6471,1980,8451,1232,9683,20650,46.89%,31.34%
0,第9案,花蓮縣新城鄉,6577,1897,8474,685,9159,17029,53.78%,38.62%
0,第9案,花蓮縣吉安鄉,28426,6905,35331,2503,37834,72116,52.46%,39.42%
0,第9案,花蓮縣壽豐鄉,5961,1919,7880,861,8741,15847,55.16%,37.62%
0,第9案,花蓮縣光復鄉,3869,1206,5075,741,5816,11417,50.94%,33.89%
0,第9案,花蓮縣豐濱鄉,1129,456,1585,302,1887,4395,42.94%,25.69%
0,第9案,花蓮縣瑞穗鄉,3418,1003,4421,601,5022,10279,48.86%,33.25%
0,第9案,花蓮縣富里鄉,2681,890,3571,547,4118,9065,45.43%,29.58%
0,第9案,花蓮縣秀林鄉,4080,1398,5478,550,6028,12562,47.99%,32.48%
0,第9案,花蓮縣萬榮鄉,1748,734,2482,344,2826,5269,53.63%,33.18%
0,第9案,花蓮縣卓溪鄉,1801,540,2341,338,2679,4947,54.15%,36.41%
0,第9案,臺東縣,65154,19668,84822,9028,93850,185996,50.46%,35.03%
0,第9案,臺東縣臺東市,34398,9425,43823,3431,47254,87803,53.82%,39.18%
0,第9案,臺東縣成功鎮,4034,1197,5231,846,6077,12426,48.91%,32.46%
0,第9案,臺東縣關山鎮,2664,750,3414,259,3673,7509,48.91%,35.48%
0,第9案,臺東縣卑南鄉,5260,1677,6937,840,7777,14976,51.93%,35.12%
0,第9案,臺東縣鹿野鄉,2037,707,2744,342,3086,6936,44.49%,29.37%
0,第9案,臺東縣池上鄉,2180,719,2899,342,3241,7162,45.25%,30.44%
0,第9案,臺東縣東河鄉,2037,739,2776,424,3200,7635,41.91%,26.68%
0,第9案,臺東縣長濱鄉,1578,567,2145,448,2593,6484,39.99%,24.34%
0,第9案,臺東縣太麻里鄉,3009,1008,4017,545,4562,9666,47.2%,31.13%
0,第9案,臺東縣大武鄉,1563,565,2128,543,2671,5266,50.72%,29.68%
0,第9案,臺東縣綠島鄉,1139,317,1456,92,1548,3579,43.25%,31.82%
0,第9案,臺東縣海端鄉,1102,424,1526,206,1732,3278,52.84%,33.62%
0,第9案,臺東縣延平鄉,979,346,1325,186,1511,2930,51.57%,33.41%
0,第9案,臺東縣金峰鄉,1011,396,1407,210,1617,3028,53.4%,33.39%
0,第9案,臺東縣達仁鄉,1191,388,1579,186,1765,3137,56.26%,37.97%
0,第9案,臺東縣蘭嶼鄉,972,443,1415,128,1543,4181,36.91%,23.25%
0,第9案,澎湖縣,28923,7616,36539,3443,39982,90405,44.23%,31.99%
0,第9案,澎湖縣馬公市,19190,4770,23960,1889,25849,53655,48.18%,35.77%
0,第9案,澎湖縣湖西鄉,3895,988,4883,469,5352,12741,42.01%,30.57%
0,第9案,澎湖縣白沙鄉,2487,741,3228,372,3600,8625,41.74%,28.83%
0,第9案,澎湖縣西嶼鄉,1545,522,2067,362,2429,7382,32.9%,20.93%
0,第9案,澎湖縣望安鄉,1146,380,1526,233,1759,4628,38.01%,24.76%
0,第9案,澎湖縣七美鄉,660,215,875,118,993,3374,29.43%,19.56%
0,第9案,金門縣,33982,6656,40638,3092,43730,122695,35.64%,27.7%
0,第9案,金門縣金城鎮,10357,1954,12311,872,13183,37815,34.86%,27.39%
0,第9案,金門縣金沙鎮,5110,907,6017,545,6562,18560,35.36%,27.53%
0,第9案,金門縣金湖鎮,7148,1498,8646,730,9376,25915,36.18%,27.58%
0,第9案,金門縣金寧鄉,7833,1706,9539,651,10190,28162,36.18%,27.81%
0,第9案,金門縣烈嶼鄉,3399,572,3971,283,4254,11676,36.43%,29.11%
0,第9案,金門縣烏坵鄉,135,19,154,11,165,567,29.1%,23.81%
0,第9案,連江縣,4751,736,5487,248,5735,11205,51.18%,42.4%
0,第9案,連江縣南竿鄉,2746,396,3142,132,3274,6461,50.67%,42.5%
0,第9案,連江縣北竿鄉,888,162,1050,53,1103,2125,51.91%,41.79%
0,第9案,連江縣莒光鄉,620,112,732,45,777,1481,52.46%,41.86%
0,第9案,連江縣東引鄉,497,66,563,18,581,1138,51.05%,43.67%
0,第9案,基隆市,119425,33714,153139,9960,163099,320030,50.96%,37.32%
0,第9案,基隆市中正區,15237,4438,19675,1514,21189,45545,46.52%,33.45%
0,第9案,基隆市七堵區,17292,5343,22635,1570,24205,46256,52.33%,37.38%
0,第9案,基隆市暖暖區,12776,3535,16311,832,17143,33225,51.6%,38.45%
0,第9案,基隆市仁愛區,13796,4161,17957,1543,19500,36738,53.08%,37.55%
0,第9案,基隆市中山區,15210,4487,19697,1264,20961,41856,50.08%,36.34%
0,第9案,基隆市安樂區,27117,7202,34319,2039,36358,70396,51.65%,38.52%
0,第9案,基隆市信義區,17997,4548,22545,1198,23743,46014,51.6%,39.11%
0,第9案,新竹市,146486,39257,185743,10937,196680,351775,55.91%,41.64%
0,第9案,新竹市東區,69052,18559,87611,4576,92187,163757,56.29%,42.17%
0,第9案,新竹市北區,50518,13579,64097,4102,68199,123122,55.39%,41.03%
0,第9案,新竹市香山區,26916,7119,34035,2259,36294,64896,55.93%,41.48%
0,第9案,嘉義市,84825,25741,110566,7468,118034,221553,53.28%,38.29%
0,第9案,嘉義市東區,38093,12423,50516,3289,53805,100647,53.46%,37.85%
0,第9案,嘉義市西區,46732,13318,60050,4179,64229,120906,53.12%,38.65%
0,第10案,全國,7658008,2907429,10565437,459508,11024945,19757067,55.8%,38.76%
0,第10案,臺北市,818887,429583,1248470,46997,1295467,2228430,58.13%,36.75%
0,第10案,臺北市松山區,63084,33872,96956,3581,100537,169278,59.39%,37.27%
0,第10案,臺北市信義區,71262,36103,107365,3914,111279,190444,58.43%,37.42%
0,第10案,臺北市大安區,91356,50083,141439,4695,146134,252645,57.84%,36.16%
0,第10案,臺北市中山區,69454,38233,107687,4219,111906,195148,57.34%,35.59%
0,第10案,臺北市中正區,47831,24913,72744,2545,75289,128292,58.69%,37.28%
0,第10案,臺北市大同區,39399,20803,60202,2626,62828,107557,58.41%,36.63%
0,第10案,臺北市萬華區,59594,28387,87981,4037,92018,164020,56.1%,36.33%
0,第10案,臺北市文山區,86838,44249,131087,4971,136058,227211,59.88%,38.22%
0,第10案,臺北市南港區,38210,19646,57856,1967,59823,101907,58.7%,37.49%
0,第10案,臺北市內湖區,86554,47892,134446,4360,138806,236824,58.61%,36.55%
0,第10案,臺北市士林區,88429,45761,134190,5537,139727,241854,57.77%,36.56%
0,第10案,臺北市北投區,76876,39641,116517,4545,121062,213250,56.77%,36.05%
0,第10案,新北市,1259036,539138,1798174,78810,1876984,3375513,55.61%,37.3%
0,第10案,新北市板橋區,176457,77394,253851,10798,264649,463411,57.11%,38.08%
0,第10案,新北市三重區,121782,54186,175968,9407,185375,329846,56.2%,36.92%
0,第10案,新北市中和區,134952,57145,192097,7506,199603,355978,56.07%,37.91%
0,第10案,新北市永和區,74085,32814,106899,4094,110993,187798,59.1%,39.45%
0,第10案,新北市新莊區,132191,57351,189542,8227,197769,344981,57.33%,38.32%
0,第10案,新北市新店區,101656,43236,144892,5427,150319,264053,56.93%,38.5%
0,第10案,新北市樹林區,56928,23771,80699,3859,84558,152102,55.59%,37.43%
0,第10案,新北市鶯歌區,26295,10394,36689,1585,38274,71645,53.42%,36.7%
0,第10案,新北市三峽區,34546,13393,47939,2096,50035,94291,53.06%,36.64%
0,第10案,新北市淡水區,52094,23054,75148,3010,78158,147272,53.07%,35.37%
0,第10案,新北市汐止區,60784,27746,88530,3884,92414,173831,53.16%,34.97%
0,第10案,新北市瑞芳區,12024,4137,16161,972,17133,35036,48.9%,34.32%
0,第10案,新北市土城區,74066,32234,106300,4371,110671,200783,55.12%,36.89%
0,第10案,新北市蘆洲區,59667,26519,86186,3860,90046,167457,53.77%,35.63%
0,第10案,新北市五股區,26544,10584,37128,1731,38859,72443,53.64%,36.64%
0,第10案,新北市泰山區,24580,9739,34319,1376,35695,64252,55.55%,38.26%
0,第10案,新北市林口區,31765,14737,46502,1863,48365,86203,56.11%,36.85%
0,第10案,新北市深坑區,7628,3300,10928,489,11417,20624,55.36%,36.99%
0,第10案,新北市石碇區,2501,819,3320,212,3532,6861,51.48%,36.45%
0,第10案,新北市坪林區,2167,638,2805,233,3038,5891,51.57%,36.78%
0,第10案,新北市三芝區,6808,2518,9326,501,9827,20119,48.84%,33.84%
0,第10案,新北市石門區,3815,1320,5135,330,5465,10528,51.91%,36.24%
0,第10案,新北市八里區,11996,4660,16656,863,17519,32970,53.14%,36.38%
0,第10案,新北市平溪區,1582,385,1967,156,2123,4321,49.13%,36.61%
0,第10案,新北市雙溪區,2822,798,3620,281,3901,7999,48.77%,35.28%
0,第10案,新北市貢寮區,3533,1148,4681,364,5045,11279,44.73%,31.32%
0,第10案,新北市金山區,6755,2267,9022,626,9648,18978,50.84%,35.59%
0,第10案,新北市萬里區,6895,2179,9074,589,9663,19297,50.08%,35.73%
0,第10案,新北市烏來區,2118,672,2790,100,2890,5264,54.9%,40.24%
0,第10案,桃園市,655472,245285,900757,33409,934166,1801823,51.85%,36.38%
0,第10案,桃園市桃園區,123326,53798,177124,6175,183299,359790,50.95%,34.28%
0,第10案,桃園市中壢區,123638,46978,170616,5915,176531,334402,52.79%,36.97%
0,第10案,桃園市大溪區,29684,9924,39608,1971,41579,78285,53.11%,37.92%
0,第10案,桃園市楊梅區,51619,16617,68236,2449,70685,137917,51.25%,37.43%
0,第10案,桃園市蘆竹區,45943,18188,64131,2227,66358,129252,51.34%,35.55%
0,第10案,桃園市大園區,26423,9401,35824,1374,37198,73900,50.34%,35.76%
0,第10案,桃園市龜山區,44517,18410,62927,2307,65234,131702,49.53%,33.8%
0,第10案,桃園市八德區,58470,21665,80135,3499,83634,165065,50.67%,35.42%
0,第10案,桃園市龍潭區,40228,12745,52973,1797,54770,101574,53.92%,39.6%
0,第10案,桃園市平鎮區,69987,24798,94785,3205,97990,183560,53.38%,38.13%
0,第10案,桃園市新屋區,17013,5147,22160,1106,23266,41461,56.12%,41.03%
0,第10案,桃園市觀音區,20031,6852,26883,1149,28032,55149,50.83%,36.32%
0,第10案,桃園市復興區,4593,762,5355,235,5590,9766,57.24%,47.03%
0,第10案,臺中市,937001,342349,1279350,59467,1338817,2295642,58.32%,40.82%
0,第10案,臺中市中區,5864,1992,7856,390,8246,14696,56.11%,39.9%
0,第10案,臺中市東區,26787,9626,36413,1821,38234,64291,59.47%,41.67%
0,第10案,臺中市南區,43492,17918,61410,2619,64029,103643,61.78%,41.96%
0,第10案,臺中市西區,37391,16558,53949,2062,56011,95040,58.93%,39.34%
0,第10案,臺中市北區,48410,19874,68284,2635,70919,124621,56.91%,38.85%
0,第10案,臺中市西屯區,72436,30741,103177,4169,107346,183814,58.4%,39.41%
0,第10案,臺中市南屯區,55403,23888,79291,3074,82365,135448,60.81%,40.9%
0,第10案,臺中市北屯區,90632,35861,126493,4881,131374,227720,57.69%,39.8%
0,第10案,臺中市豐原區,58173,20463,78636,4034,82670,136658,60.49%,42.57%
0,第10案,臺中市東勢區,19191,4955,24146,1376,25522,43181,59.1%,44.44%
0,第10案,臺中市大甲區,26092,8849,34941,1781,36722,63069,58.23%,41.37%
0,第10案,臺中市清水區,29922,9817,39739,2494,42233,71528,59.04%,41.83%
0,第10案,臺中市沙鹿區,30000,10467,40467,1966,42433,74207,57.18%,40.43%
0,第10案,臺中市梧棲區,18872,6614,25486,1500,26986,47040,57.37%,40.12%
0,第10案,臺中市后里區,18408,6384,24792,1510,26302,44962,58.5%,40.94%
0,第10案,臺中市神岡區,23506,7436,30942,1566,32508,54565,59.58%,43.08%
0,第10案,臺中市潭子區,37149,12501,49650,2142,51792,89487,57.88%,41.51%
0,第10案,臺中市大雅區,31639,11087,42726,1836,44562,77189,57.73%,40.99%
0,第10案,臺中市新社區,8396,2292,10688,611,11299,20860,54.17%,40.25%
0,第10案,臺中市石岡區,5561,1612,7173,474,7647,12880,59.37%,43.18%
0,第10案,臺中市外埔區,11728,3418,15146,787,15933,27059,58.88%,43.34%
0,第10案,臺中市大安區,7095,2058,9153,626,9779,16520,59.19%,42.95%
0,第10案,臺中市烏日區,25322,8987,34309,1983,36292,61705,58.82%,41.04%
0,第10案,臺中市大肚區,20041,6262,26303,1498,27801,47457,58.58%,42.23%
0,第10案,臺中市龍井區,25559,8813,34372,1738,36110,63584,56.79%,40.2%
0,第10案,臺中市霧峰區,24043,7594,31637,1878,33515,55225,60.69%,43.54%
0,第10案,臺中市太平區,62027,21251,83278,3818,87096,157926,55.15%,39.28%
0,第10案,臺中市大里區,69234,24075,93309,3867,97176,171769,56.57%,40.31%
0,第10案,臺中市和平區,4628,956,5584,331,5915,9498,62.28%,48.73%
0,第10案,臺南市,582450,217619,800069,32604,832673,1594821,52.21%,36.52%
0,第10案,臺南市新營區,22927,8754,31681,1163,32844,64949,50.57%,35.3%
0,第10案,臺南市鹽水區,7778,2522,10300,573,10873,22121,49.15%,35.16%
0,第10案,臺南市白河區,7975,2508,10483,657,11140,24894,44.75%,32.04%
0,第10案,臺南市柳營區,6828,2082,8910,599,9509,18804,50.57%,36.31%
0,第10案,臺南市後壁區,7155,2165,9320,605,9925,20841,47.62%,34.33%
0,第10案,臺南市東山區,5363,1544,6907,424,7331,18471,39.69%,29.03%
0,第10案,臺南市麻豆區,13400,4974,18374,751,19125,37963,50.38%,35.3%
0,第10案,臺南市下營區,7279,2326,9605,521,10126,20947,48.34%,34.75%
0,第10案,臺南市六甲區,6261,2575,8836,572,9408,19144,49.14%,32.7%
0,第10案,臺南市官田區,6624,2280,8904,429,9333,18675,49.98%,35.47%
0,第10案,臺南市大內區,3200,821,4021,253,4274,8654,49.39%,36.98%
0,第10案,臺南市佳里區,19170,6512,25682,1073,26755,50407,53.08%,38.03%
0,第10案,臺南市學甲區,8001,2459,10460,489,10949,22567,48.52%,35.45%
0,第10案,臺南市西港區,7409,2402,9811,422,10233,21564,47.45%,34.36%
0,第10案,臺南市七股區,7258,2011,9269,387,9656,19950,48.4%,36.38%
0,第10案,臺南市將軍區,5971,2120,8091,359,8450,17754,47.59%,33.63%
0,第10案,臺南市北門區,3242,836,4078,183,4261,9925,42.93%,32.66%
0,第10案,臺南市新化區,14534,4924,19458,878,20336,37296,54.53%,38.97%
0,第10案,臺南市善化區,14283,5725,20008,875,20883,39950,52.27%,35.75%
0,第10案,臺南市新市區,11632,4216,15848,651,16499,30386,54.3%,38.28%
0,第10案,臺南市安定區,10120,3357,13477,814,14291,26104,54.75%,38.77%
0,第10案,臺南市山上區,2134,646,2780,173,2953,6511,45.35%,32.78%
0,第10案,臺南市玉井區,4582,1248,5830,300,6130,12357,49.61%,37.08%
0,第10案,臺南市楠西區,2941,761,3702,210,3912,8528,45.87%,34.49%
0,第10案,臺南市南化區,2782,756,3538,202,3740,7786,48.03%,35.73%
0,第10案,臺南市左鎮區,1615,332,1947,129,2076,4418,46.99%,36.56%
0,第10案,臺南市仁德區,25012,8676,33688,1277,34965,64632,54.1%,38.7%
0,第10案,臺南市歸仁區,21719,8119,29838,1172,31010,57387,54.04%,37.85%
0,第10案,臺南市關廟區,11757,3807,15564,757,16321,29913,54.56%,39.3%
0,第10案,臺南市龍崎區,1411,367,1778,101,1879,3713,50.61%,38%
0,第10案,臺南市永康區,71049,28157,99206,3316,102522,195001,52.58%,36.44%
0,第10案,臺南市東區,57015,24980,81995,2502,84497,153359,55.1%,37.18%
0,第10案,臺南市南區,39517,14859,54376,2375,56751,108650,52.23%,36.37%
0,第10案,臺南市北區,41640,17038,58678,1741,60419,110906,54.48%,37.55%
0,第10案,臺南市安南區,58866,22149,81015,3312,84327,159654,52.82%,36.87%
0,第10案,臺南市安平區,19053,8273,27326,1078,28404,55379,51.29%,34.4%
0,第10案,臺南市中西區,24947,10338,35285,1281,36566,65261,56.03%,38.23%
0,第10案,高雄市,1005282,355705,1360987,49113,1410100,2353342,59.92%,42.72%
0,第10案,高雄市鹽埕區,8969,3626,12595,346,12941,21617,59.86%,41.49%
0,第10案,高雄市鼓山區,48435,19166,67601,1977,69578,114979,60.51%,42.13%
0,第10案,高雄市左營區,70061,26437,96498,2660,99158,161367,61.45%,43.42%
0,第10案,高雄市楠梓區,65220,23747,88967,3312,92279,153132,60.26%,42.59%
0,第10案,高雄市三民區,121735,48041,169776,4983,174759,289519,60.36%,42.05%
0,第10案,高雄市新興區,19319,7718,27037,844,27881,44355,62.86%,43.56%
0,第10案,高雄市前金區,10387,3996,14383,455,14838,23928,62.01%,43.41%
0,第10案,高雄市苓雅區,64689,24674,89363,2570,91933,146786,62.63%,44.07%
0,第10案,高雄市前鎮區,68512,24607,93119,3463,96582,161797,59.69%,42.34%
0,第10案,高雄市旗津區,9528,3540,13068,554,13622,24860,54.79%,38.33%
0,第10案,高雄市小港區,56814,19977,76791,2643,79434,132733,59.84%,42.8%
0,第10案,高雄市鳳山區,130402,45870,176272,5878,182150,300510,60.61%,43.39%
0,第10案,高雄市林園區,24254,7968,32222,1465,33687,59129,56.97%,41.02%
0,第10案,高雄市大寮區,41344,13324,54668,2065,56733,97309,58.3%,42.49%
0,第10案,高雄市大樹區,15423,4625,20048,910,20958,36772,56.99%,41.94%
0,第10案,高雄市大社區,12290,4430,16720,758,17478,30046,58.17%,40.9%
0,第10案,高雄市仁武區,31863,10599,42462,1244,43706,73611,59.37%,43.29%
0,第10案,高雄市鳥松區,16980,6317,23297,815,24112,39191,61.52%,43.33%
0,第10案,高雄市岡山區,36943,11832,48775,1764,50539,81244,62.21%,45.47%
0,第10案,高雄市橋頭區,14932,4943,19875,832,20707,32565,63.59%,45.85%
0,第10案,高雄市燕巢區,10820,3489,14309,785,15094,26012,58.03%,41.6%
0,第10案,高雄市田寮區,2480,596,3076,232,3308,6671,49.59%,37.18%
0,第10案,高雄市阿蓮區,9799,3220,13019,539,13558,24534,55.26%,39.94%
0,第10案,高雄市路竹區,18878,6137,25015,1185,26200,43850,59.75%,43.05%
0,第10案,高雄市湖內區,10650,3395,14045,622,14667,25729,57.01%,41.39%
0,第10案,高雄市茄萣區,10434,3315,13749,700,14449,26212,55.12%,39.81%
0,第10案,高雄市永安區,5565,1716,7281,367,7648,12001,63.73%,46.37%
0,第10案,高雄市彌陀區,7695,2184,9879,469,10348,16487,62.76%,46.67%
0,第10案,高雄市梓官區,14003,4142,18145,719,18864,31025,60.8%,45.13%
0,第10案,高雄市旗山區,13439,3938,17377,982,18359,31996,57.38%,42%
0,第10案,高雄市美濃區,14658,3656,18314,1282,19596,35311,55.5%,41.51%
0,第10案,高雄市六龜區,4006,1040,5046,481,5527,11501,48.06%,34.83%
0,第10案,高雄市甲仙區,1987,523,2510,249,2759,5417,50.93%,36.68%
0,第10案,高雄市杉林區,3781,920,4701,329,5030,10607,47.42%,35.65%
0,第10案,高雄市內門區,4951,1203,6154,420,6574,13002,50.56%,38.08%
0,第10案,高雄市茂林區,865,190,1055,68,1123,1615,69.54%,53.56%
0,第10案,高雄市桃源區,1747,348,2095,73,2168,3498,61.98%,49.94%
0,第10案,高雄市那瑪夏區,1424,256,1680,73,1753,2424,72.32%,58.75%
0,第10案,新竹縣,181680,63339,245019,8964,253983,445051,57.07%,40.82%
0,第10案,新竹縣竹北市,53786,24075,77861,2328,80189,137129,58.48%,39.22%
0,第10案,新竹縣竹東鎮,31110,10315,41425,1472,42897,78794,54.44%,39.48%
0,第10案,新竹縣新埔鎮,12060,3598,15658,704,16362,28894,56.63%,41.74%
0,第10案,新竹縣關西鎮,10622,2908,13530,602,14132,24712,57.19%,42.98%
0,第10案,新竹縣湖口鄉,26323,8274,34597,1276,35873,63511,56.48%,41.45%
0,第10案,新竹縣新豐鄉,18858,5985,24843,881,25724,45790,56.18%,41.18%
0,第10案,新竹縣芎林鄉,7391,2410,9801,446,10247,17293,59.26%,42.74%
0,第10案,新竹縣橫山鄉,5052,1310,6362,378,6740,11346,59.4%,44.53%
0,第10案,新竹縣北埔鄉,3431,1020,4451,209,4660,8180,56.97%,41.94%
0,第10案,新竹縣寶山鄉,5395,1934,7329,307,7636,12973,58.86%,41.59%
0,第10案,新竹縣峨眉鄉,2327,594,2921,156,3077,5068,60.71%,45.92%
0,第10案,新竹縣尖石鄉,3551,573,4124,140,4264,7364,57.9%,48.22%
0,第10案,新竹縣五峰鄉,1774,343,2117,65,2182,3997,54.59%,44.38%
0,第10案,苗栗縣,193302,58441,251743,11832,263575,461580,57.1%,41.88%
0,第10案,苗栗縣苗栗市,31728,9817,41545,1549,43094,74249,58.04%,42.73%
0,第10案,苗栗縣苑裡鎮,16565,4721,21286,1128,22414,38890,57.63%,42.59%
0,第10案,苗栗縣通霄鎮,12021,3476,15497,821,16318,29709,54.93%,40.46%
0,第10案,苗栗縣竹南鎮,27788,9368,37156,1469,38625,68528,56.36%,40.55%
0,第10案,苗栗縣頭份市,34848,10973,45821,1742,47563,83617,56.88%,41.68%
0,第10案,苗栗縣後龍鎮,12396,3728,16124,1014,17138,30948,55.38%,40.05%
0,第10案,苗栗縣卓蘭鎮,6376,1908,8284,414,8698,14772,58.88%,43.16%
0,第10案,苗栗縣大湖鄉,5014,1401,6415,353,6768,12653,53.49%,39.63%
0,第10案,苗栗縣公館鄉,12174,3678,15852,907,16759,28318,59.18%,42.99%
0,第10案,苗栗縣銅鑼鄉,6310,1866,8176,467,8643,15424,56.04%,40.91%
0,第10案,苗栗縣南庄鄉,3233,869,4102,246,4348,8784,49.5%,36.81%
0,第10案,苗栗縣頭屋鄉,4569,1286,5855,266,6121,9390,65.19%,48.66%
0,第10案,苗栗縣三義鄉,6114,1678,7792,366,8158,13889,58.74%,44.02%
0,第10案,苗栗縣西湖鄉,2657,718,3375,182,3557,6382,55.73%,41.63%
0,第10案,苗栗縣造橋鄉,4728,1328,6056,380,6436,11027,58.37%,42.88%
0,第10案,苗栗縣三灣鄉,2498,664,3162,226,3388,5852,57.89%,42.69%
0,第10案,苗栗縣獅潭鄉,1565,343,1908,139,2047,3968,51.59%,39.44%
0,第10案,苗栗縣泰安鄉,2718,619,3337,163,3500,5180,67.57%,52.47%
0,第10案,彰化縣,447132,139760,586892,28923,615815,1066994,57.71%,41.91%
0,第10案,彰化縣彰化市,82890,29022,111912,4211,116123,190995,60.8%,43.4%
0,第10案,彰化縣鹿港鎮,30405,9044,39449,1862,41311,70505,58.59%,43.12%
0,第10案,彰化縣和美鎮,30653,10373,41026,1809,42835,75286,56.9%,40.72%
0,第10案,彰化縣線西鄉,6150,1832,7982,454,8436,14065,59.98%,43.73%
0,第10案,彰化縣伸港鄉,12387,4001,16388,900,17288,30407,56.86%,40.74%
0,第10案,彰化縣福興鄉,15883,4653,20536,1075,21611,39745,54.37%,39.96%
0,第10案,彰化縣秀水鄉,13956,4445,18401,927,19328,32394,59.67%,43.08%
0,第10案,彰化縣花壇鄉,17218,5170,22388,926,23314,38924,59.9%,44.23%
0,第10案,彰化縣芬園鄉,8360,2461,10821,652,11473,20408,56.22%,40.96%
0,第10案,彰化縣員林市,41969,14102,56071,2267,58338,102028,57.18%,41.13%
0,第10案,彰化縣溪湖鎮,19037,6014,25051,1167,26218,45147,58.07%,42.17%
0,第10案,彰化縣田中鎮,15277,4379,19656,989,20645,35391,58.33%,43.17%
0,第10案,彰化縣大村鄉,13606,4239,17845,874,18719,31492,59.44%,43.2%
0,第10案,彰化縣埔鹽鄉,12636,3341,15977,989,16966,28026,60.54%,45.09%
0,第10案,彰化縣埔心鄉,13270,4073,17343,1013,18356,29642,61.93%,44.77%
0,第10案,彰化縣永靖鄉,13773,4101,17874,896,18770,31239,60.09%,44.09%
0,第10案,彰化縣社頭鄉,15535,4604,20139,917,21056,36306,58%,42.79%
0,第10案,彰化縣二水鄉,5976,1711,7687,445,8132,13339,60.96%,44.8%
0,第10案,彰化縣北斗鎮,11911,3461,15372,821,16193,27593,58.69%,43.17%
0,第10案,彰化縣二林鎮,16632,4841,21473,1303,22776,42976,53%,38.7%
0,第10案,彰化縣田尾鄉,10063,2986,13049,752,13801,23179,59.54%,43.41%
0,第10案,彰化縣埤頭鄉,9848,2898,12746,902,13648,25677,53.15%,38.35%
0,第10案,彰化縣芳苑鄉,10493,2804,13297,1056,14353,29291,49%,35.82%
0,第10案,彰化縣大城鄉,4311,1049,5360,403,5763,14713,39.17%,29.3%
0,第10案,彰化縣竹塘鄉,5147,1423,6570,497,7067,12821,55.12%,40.15%
0,第10案,彰化縣溪州鄉,9746,2733,12479,816,13295,25405,52.33%,38.36%
0,第10案,南投縣,184051,52700,236751,12381,249132,427089,58.33%,43.09%
0,第10案,南投縣南投市,37547,11607,49154,2104,51258,84328,60.78%,44.52%
0,第10案,南投縣埔里鎮,29571,8292,37863,1923,39786,68763,57.86%,43%
0,第10案,南投縣草屯鎮,35215,11289,46504,2014,48518,82922,58.51%,42.47%
0,第10案,南投縣竹山鎮,19254,5389,24643,1474,26117,47034,55.53%,40.94%
0,第10案,南投縣集集鎮,4034,1229,5263,319,5582,9611,58.08%,41.97%
0,第10案,南投縣名間鄉,14533,4339,18872,1282,20154,33408,60.33%,43.5%
0,第10案,南投縣鹿谷鄉,6472,1638,8110,500,8610,15941,54.01%,40.6%
0,第10案,南投縣中寮鄉,5748,1422,7170,495,7665,13181,58.15%,43.61%
0,第10案,南投縣魚池鄉,5603,1534,7137,479,7616,13958,54.56%,40.14%
0,第10案,南投縣國姓鄉,7089,1754,8843,554,9397,16597,56.62%,42.71%
0,第10案,南投縣水里鄉,6392,1795,8187,478,8665,15458,56.06%,41.35%
0,第10案,南投縣信義鄉,6891,1216,8107,412,8519,13299,64.06%,51.82%
0,第10案,南投縣仁愛鄉,5702,1196,6898,347,7245,12589,57.55%,45.29%
0,第10案,雲林縣,218210,68279,286489,18949,305438,584480,52.26%,37.33%
0,第10案,雲林縣斗六市,37033,12751,49784,2138,51922,89761,57.84%,41.26%
0,第10案,雲林縣斗南鎮,15902,4987,20889,1103,21992,38138,57.66%,41.7%
0,第10案,雲林縣虎尾鎮,22353,7509,29862,1476,31338,58167,53.88%,38.43%
0,第10案,雲林縣西螺鎮,14136,5125,19261,1296,20557,38142,53.9%,37.06%
0,第10案,雲林縣土庫鎮,9140,2883,12023,949,12972,24412,53.14%,37.44%
0,第10案,雲林縣北港鎮,13375,4138,17513,1149,18662,33958,54.96%,39.39%
0,第10案,雲林縣古坑鄉,10581,3109,13690,984,14674,27477,53.4%,38.51%
0,第10案,雲林縣大埤鄉,6372,1732,8104,519,8623,16509,52.23%,38.6%
0,第10案,雲林縣莿桐鄉,9597,3037,12634,983,13617,24570,55.42%,39.06%
0,第10案,雲林縣林內鄉,6350,1851,8201,658,8859,15551,56.97%,40.83%
0,第10案,雲林縣二崙鄉,7998,2436,10434,874,11308,23367,48.39%,34.23%
0,第10案,雲林縣崙背鄉,7445,2190,9635,760,10395,21050,49.38%,35.37%
0,第10案,雲林縣麥寮鄉,13085,4055,17140,1160,18300,37119,49.3%,35.25%
0,第10案,雲林縣東勢鄉,4780,1364,6144,485,6629,13239,50.07%,36.11%
0,第10案,雲林縣褒忠鄉,4110,1373,5483,377,5860,11381,51.49%,36.11%
0,第10案,雲林縣臺西鄉,7062,1953,9015,740,9755,21125,46.18%,33.43%
0,第10案,雲林縣元長鄉,7239,2026,9265,737,10002,22830,43.81%,31.71%
0,第10案,雲林縣四湖鄉,6015,1765,7780,656,8436,20983,40.2%,28.67%
0,第10案,雲林縣口湖鄉,8462,2123,10585,1051,11636,24193,48.1%,34.98%
0,第10案,雲林縣水林鄉,7175,1872,9047,854,9901,22508,43.99%,31.88%
0,第10案,嘉義縣,166655,48809,215464,12809,228273,442775,51.56%,37.64%
0,第10案,嘉義縣太保市,12266,3958,16224,933,17157,31568,54.35%,38.86%
0,第10案,嘉義縣朴子市,13420,4113,17533,935,18468,35191,52.48%,38.13%
0,第10案,嘉義縣布袋鎮,8612,2355,10967,848,11815,23965,49.3%,35.94%
0,第10案,嘉義縣大林鎮,10329,3045,13374,707,14081,26922,52.3%,38.37%
0,第10案,嘉義縣民雄鄉,23825,7586,31411,1672,33083,61209,54.05%,38.92%
0,第10案,嘉義縣溪口鄉,4982,1458,6440,450,6890,13105,52.58%,38.02%
0,第10案,嘉義縣新港鄉,10873,3212,14085,942,15027,27342,54.96%,39.77%
0,第10案,嘉義縣六腳鄉,6755,1735,8490,546,9036,20821,43.4%,32.44%
0,第10案,嘉義縣東石鄉,6940,1640,8580,646,9226,21915,42.1%,31.67%
0,第10案,嘉義縣義竹鄉,6137,1837,7974,565,8539,16647,51.29%,36.87%
0,第10案,嘉義縣鹿草鄉,4653,1463,6116,518,6634,13937,47.6%,33.39%
0,第10案,嘉義縣水上鄉,17400,4998,22398,1083,23481,43857,53.54%,39.67%
0,第10案,嘉義縣中埔鄉,13696,4097,17793,899,18692,39139,47.76%,34.99%
0,第10案,嘉義縣竹崎鄉,12242,3347,15589,868,16457,31228,52.7%,39.2%
0,第10案,嘉義縣梅山鄉,6892,1988,8880,671,9551,17083,55.91%,40.34%
0,第10案,嘉義縣番路鄉,4281,1105,5386,315,5701,10156,56.13%,42.15%
0,第10案,嘉義縣大埔鄉,1585,501,2086,114,2200,3999,55.01%,39.63%
0,第10案,嘉義縣阿里山鄉,1767,371,2138,97,2235,4691,47.64%,37.67%
0,第10案,屏東縣,270712,85379,356091,21016,377107,711720,52.99%,38.04%
0,第10案,屏東縣屏東市,64865,22657,87522,3447,90969,170148,53.46%,38.12%
0,第10案,屏東縣潮州鎮,17588,5413,23001,1142,24143,46444,51.98%,37.87%
0,第10案,屏東縣東港鎮,15278,4663,19941,1197,21138,39495,53.52%,38.68%
0,第10案,屏東縣恆春鎮,8603,2827,11430,696,12126,25661,47.25%,33.53%
0,第10案,屏東縣萬丹鄉,17040,5202,22242,1453,23695,43478,54.5%,39.19%
0,第10案,屏東縣長治鄉,10288,3361,13649,882,14531,26256,55.34%,39.18%
0,第10案,屏東縣麟洛鄉,4152,1465,5617,267,5884,9970,59.02%,41.64%
0,第10案,屏東縣九如鄉,7418,2324,9742,739,10481,19132,54.78%,38.77%
0,第10案,屏東縣里港鄉,8492,2892,11384,971,12355,22128,55.83%,38.38%
0,第10案,屏東縣鹽埔鄉,8460,2554,11014,725,11739,22402,52.4%,37.76%
0,第10案,屏東縣高樹鄉,7475,2444,9919,931,10850,21697,50.01%,34.45%
0,第10案,屏東縣萬巒鄉,6818,1954,8772,599,9371,17945,52.22%,37.99%
0,第10案,屏東縣內埔鄉,16703,5211,21914,1228,23142,47558,48.66%,35.12%
0,第10案,屏東縣竹田鄉,6363,1888,8251,631,8882,15353,57.85%,41.44%
0,第10案,屏東縣新埤鄉,3349,899,4248,341,4589,9033,50.8%,37.08%
0,第10案,屏東縣枋寮鄉,8342,2303,10645,806,11451,21394,53.52%,38.99%
0,第10案,屏東縣新園鄉,11532,3587,15119,1213,16332,30706,53.19%,37.56%
0,第10案,屏東縣崁頂鄉,4526,1549,6075,384,6459,12270,52.64%,36.89%
0,第10案,屏東縣林邊鄉,6383,1765,8148,648,8796,15691,56.06%,40.68%
0,第10案,屏東縣南州鄉,3652,1170,4822,322,5144,9479,54.27%,38.53%
0,第10案,屏東縣佳冬鄉,6104,1799,7903,641,8544,17063,50.07%,35.77%
0,第10案,屏東縣琉球鄉,3577,818,4395,332,4727,10706,44.15%,33.41%
0,第10案,屏東縣車城鄉,2257,757,3014,198,3212,7595,42.29%,29.72%
0,第10案,屏東縣滿州鄉,2250,692,2942,167,3109,7206,43.14%,31.22%
0,第10案,屏東縣枋山鄉,1831,533,2364,168,2532,4856,52.14%,37.71%
0,第10案,屏東縣三地門鄉,2964,846,3810,164,3974,6373,62.36%,46.51%
0,第10案,屏東縣霧臺鄉,1694,464,2158,65,2223,2950,75.36%,57.42%
0,第10案,屏東縣瑪家鄉,2897,762,3659,128,3787,5663,66.87%,51.16%
0,第10案,屏東縣泰武鄉,2193,574,2767,124,2891,4344,66.55%,50.48%
0,第10案,屏東縣來義鄉,2890,701,3591,205,3796,6257,60.67%,46.19%
0,第10案,屏東縣春日鄉,1286,407,1693,46,1739,3923,44.33%,32.78%
0,第10案,屏東縣獅子鄉,2115,446,2561,93,2654,4230,62.74%,50%
0,第10案,屏東縣牡丹鄉,1327,452,1779,63,1842,4314,42.7%,30.76%
0,第10案,宜蘭縣,150234,55064,205298,11224,216522,386089,56.08%,38.91%
0,第10案,宜蘭縣宜蘭市,30720,12445,43165,1929,45094,79167,56.96%,38.8%
0,第10案,宜蘭縣羅東鎮,22790,9020,31810,1500,33310,57686,57.74%,39.51%
0,第10案,宜蘭縣蘇澳鎮,13507,4747,18254,1306,19560,34512,56.68%,39.14%
0,第10案,宜蘭縣頭城鎮,9591,3316,12907,913,13820,25135,54.98%,38.16%
0,第10案,宜蘭縣礁溪鄉,11795,4186,15981,918,16899,31084,54.37%,37.95%
0,第10案,宜蘭縣壯圍鄉,8704,3073,11777,765,12542,21447,58.48%,40.58%
0,第10案,宜蘭縣員山鄉,10506,3689,14195,1036,15231,28131,54.14%,37.35%
0,第10案,宜蘭縣冬山鄉,17229,6321,23550,1142,24692,45405,54.38%,37.95%
0,第10案,宜蘭縣五結鄉,13075,4826,17901,931,18832,34892,53.97%,37.47%
0,第10案,宜蘭縣三星鄉,6950,2597,9547,547,10094,19051,52.98%,36.48%
0,第10案,宜蘭縣大同鄉,3001,443,3444,113,3557,4935,72.08%,60.81%
0,第10案,宜蘭縣南澳鄉,2366,401,2767,124,2891,4644,62.25%,50.95%
0,第10案,花蓮縣,110028,30699,140727,7095,147822,278059,53.16%,39.57%
0,第10案,花蓮縣花蓮市,33819,10516,44335,1508,45843,84807,54.06%,39.88%
0,第10案,花蓮縣鳳林鎮,3992,998,4990,393,5383,9676,55.63%,41.26%
0,第10案,花蓮縣玉里鎮,7597,1782,9379,749,10128,20650,49.05%,36.79%
0,第10案,花蓮縣新城鄉,6871,1975,8846,436,9282,17029,54.51%,40.35%
0,第10案,花蓮縣吉安鄉,28648,8044,36692,1483,38175,72116,52.94%,39.72%
0,第10案,花蓮縣壽豐鄉,6517,1804,8321,537,8858,15847,55.9%,41.12%
0,第10案,花蓮縣光復鄉,4530,1070,5600,473,6073,11417,53.19%,39.68%
0,第10案,花蓮縣豐濱鄉,1574,461,2035,120,2155,4395,49.03%,35.81%
0,第10案,花蓮縣瑞穗鄉,3987,902,4889,336,5225,10279,50.83%,38.79%
0,第10案,花蓮縣富里鄉,2994,765,3759,389,4148,9065,45.76%,33.03%
0,第10案,花蓮縣秀林鄉,4845,1325,6170,335,6505,12562,51.78%,38.57%
0,第10案,花蓮縣萬榮鄉,2376,561,2937,172,3109,5269,59.01%,45.09%
0,第10案,花蓮縣卓溪鄉,2278,496,2774,164,2938,4947,59.39%,46.05%
0,第10案,臺東縣,72221,20213,92434,5025,97459,185996,52.4%,38.83%
0,第10案,臺東縣臺東市,35766,10460,46226,1965,48191,87803,54.89%,40.73%
0,第10案,臺東縣成功鎮,4693,1074,5767,465,6232,12426,50.15%,37.77%
0,第10案,臺東縣關山鎮,2728,810,3538,216,3754,7509,49.99%,36.33%
0,第10案,臺東縣卑南鄉,5747,1643,7390,520,7910,14976,52.82%,38.37%
0,第10案,臺東縣鹿野鄉,2190,718,2908,240,3148,6936,45.39%,31.57%
0,第10案,臺東縣池上鄉,2357,668,3025,276,3301,7162,46.09%,32.91%
0,第10案,臺東縣東河鄉,2506,657,3163,225,3388,7635,44.37%,32.82%
0,第10案,臺東縣長濱鄉,2037,517,2554,246,2800,6484,43.18%,31.42%
0,第10案,臺東縣太麻里鄉,4128,932,5060,284,5344,9666,55.29%,42.71%
0,第10案,臺東縣大武鄉,2072,520,2592,187,2779,5266,52.77%,39.35%
0,第10案,臺東縣綠島鄉,1099,443,1542,48,1590,3579,44.43%,30.71%
0,第10案,臺東縣海端鄉,1382,316,1698,73,1771,3278,54.03%,42.16%
0,第10案,臺東縣延平鄉,1326,307,1633,68,1701,2930,58.05%,45.26%
0,第10案,臺東縣金峰鄉,1527,397,1924,82,2006,3028,66.25%,50.43%
0,第10案,臺東縣達仁鄉,1446,352,1798,80,1878,3137,59.87%,46.09%
0,第10案,臺東縣蘭嶼鄉,1217,399,1616,50,1666,4181,39.85%,29.11%
0,第10案,澎湖縣,30169,9187,39356,1884,41240,90405,45.62%,33.37%
0,第10案,澎湖縣馬公市,19142,6154,25296,1087,26383,53655,49.17%,35.68%
0,第10案,澎湖縣湖西鄉,4216,1153,5369,265,5634,12741,44.22%,33.09%
0,第10案,澎湖縣白沙鄉,2808,711,3519,187,3706,8625,42.97%,32.56%
0,第10案,澎湖縣西嶼鄉,1842,514,2356,222,2578,7382,34.92%,24.95%
0,第10案,澎湖縣望安鄉,1434,396,1830,81,1911,4628,41.29%,30.99%
0,第10案,澎湖縣七美鄉,727,259,986,42,1028,3374,30.47%,21.55%
0,第10案,金門縣,32991,8977,41968,2006,43974,122695,35.84%,26.89%
0,第10案,金門縣金城鎮,10065,2610,12675,596,13271,37815,35.09%,26.62%
0,第10案,金門縣金沙鎮,5217,1043,6260,316,6576,18560,35.43%,28.11%
0,第10案,金門縣金湖鎮,7214,1841,9055,457,9512,25915,36.7%,27.84%
0,第10案,金門縣金寧鄉,7058,2711,9769,419,10188,28162,36.18%,25.06%
0,第10案,金門縣烈嶼鄉,3304,748,4052,210,4262,11676,36.5%,28.3%
0,第10案,金門縣烏坵鄉,133,24,157,8,165,567,29.1%,23.46%
0,第10案,連江縣,4341,1249,5590,179,5769,11205,51.49%,38.74%
0,第10案,連江縣南竿鄉,2485,691,3176,101,3277,6461,50.72%,38.46%
0,第10案,連江縣北竿鄉,832,234,1066,44,1110,2125,52.24%,39.15%
0,第10案,連江縣莒光鄉,592,182,774,22,796,1481,53.75%,39.97%
0,第10案,連江縣東引鄉,432,142,574,12,586,1138,51.49%,37.96%
0,第10案,基隆市,116173,44691,160864,6056,166920,320030,52.16%,36.3%
0,第10案,基隆市中正區,15445,5335,20780,966,21746,45545,47.75%,33.91%
0,第10案,基隆市七堵區,17231,6505,23736,917,24653,46256,53.3%,37.25%
0,第10案,基隆市暖暖區,12321,4869,17190,517,17707,33225,53.29%,37.08%
0,第10案,基隆市仁愛區,13703,5184,18887,879,19766,36738,53.8%,37.3%
0,第10案,基隆市中山區,15249,5791,21040,835,21875,41856,52.26%,36.43%
0,第10案,基隆市安樂區,25328,10288,35616,1183,36799,70396,52.27%,35.98%
0,第10案,基隆市信義區,16896,6719,23615,759,24374,46014,52.97%,36.72%
0,第10案,新竹市,135398,58148,193546,7006,200552,351775,57.01%,38.49%
0,第10案,新竹市東區,61929,29183,91112,2981,94093,163757,57.46%,37.82%
0,第10案,新竹市北區,47686,19422,67108,2558,69666,123122,56.58%,38.73%
0,第10案,新竹市香山區,25783,9543,35326,1467,36793,64896,56.7%,39.73%
0,第10案,嘉義市,86583,32815,119398,3759,123157,221553,55.59%,39.08%
0,第10案,嘉義市東區,38806,15349,54155,1598,55753,100647,55.39%,38.56%
0,第10案,嘉義市西區,47777,17466,65243,2161,67404,120906,55.75%,39.52%
0,第11案,全國,7083379,3419624,10503003,507101,11010104,19757067,55.73%,35.85%
0,第11案,臺北市,779447,462976,1242423,50717,1293140,2228430,58.03%,34.98%
0,第11案,臺北市松山區,60838,35764,96602,3958,100560,169278,59.41%,35.94%
0,第11案,臺北市信義區,67363,39247,106610,4367,110977,190444,58.27%,35.37%
0,第11案,臺北市大安區,88535,52709,141244,4992,146236,252645,57.88%,35.04%
0,第11案,臺北市中山區,66307,40817,107124,4427,111551,195148,57.16%,33.98%
0,第11案,臺北市中正區,45658,26747,72405,2797,75202,128292,58.62%,35.59%
0,第11案,臺北市大同區,36686,23038,59724,2890,62614,107557,58.21%,34.11%
0,第11案,臺北市萬華區,55309,31888,87197,4541,91738,164020,55.93%,33.72%
0,第11案,臺北市文山區,84069,47142,131211,5129,136340,227211,60.01%,37%
0,第11案,臺北市南港區,35738,21712,57450,2126,59576,101907,58.46%,35.07%
0,第11案,臺北市內湖區,83195,50907,134102,4545,138647,236824,58.54%,35.13%
0,第11案,臺北市士林區,82768,50109,132877,6015,138892,241854,57.43%,34.22%
0,第11案,臺北市北投區,72981,42896,115877,4930,120807,213250,56.65%,34.22%
0,第11案,新北市,1174782,617886,1792668,83090,1875758,3375513,55.57%,34.8%
0,第11案,新北市板橋區,165739,87319,253058,11481,264539,463411,57.09%,35.77%
0,第11案,新北市三重區,112720,62661,175381,10091,185472,329846,56.23%,34.17%
0,第11案,新北市中和區,128026,63253,191279,7610,198889,355978,55.87%,35.96%
0,第11案,新北市永和區,70523,36568,107091,4290,111381,187798,59.31%,37.55%
0,第11案,新北市新莊區,122586,65677,188263,9065,197328,344981,57.2%,35.53%
0,第11案,新北市新店區,96556,47821,144377,5820,150197,264053,56.88%,36.57%
0,第11案,新北市樹林區,52556,28151,80707,3757,84464,152102,55.53%,34.55%
0,第11案,新北市鶯歌區,23926,12697,36623,1652,38275,71645,53.42%,33.4%
0,第11案,新北市三峽區,31817,16221,48038,2032,50070,94291,53.1%,33.74%
0,第11案,新北市淡水區,49398,25857,75255,2900,78155,147272,53.07%,33.54%
0,第11案,新北市汐止區,56900,31479,88379,3897,92276,173831,53.08%,32.73%
0,第11案,新北市瑞芳區,10789,5332,16121,1060,17181,35036,49.04%,30.79%
0,第11案,新北市土城區,68330,37301,105631,4977,110608,200783,55.09%,34.03%
0,第11案,新北市蘆洲區,54605,31092,85697,4278,89975,167457,53.73%,32.61%
0,第11案,新北市五股區,24500,12684,37184,1782,38966,72443,53.79%,33.82%
0,第11案,新北市泰山區,22738,11509,34247,1389,35636,64252,55.46%,35.39%
0,第11案,新北市林口區,29960,16503,46463,1896,48359,86203,56.1%,34.76%
0,第11案,新北市深坑區,7111,3814,10925,475,11400,20624,55.28%,34.48%
0,第11案,新北市石碇區,2196,1094,3290,226,3516,6861,51.25%,32.01%
0,第11案,新北市坪林區,1929,851,2780,247,3027,5891,51.38%,32.74%
0,第11案,新北市三芝區,6012,3223,9235,572,9807,20119,48.74%,29.88%
0,第11案,新北市石門區,3393,1701,5094,374,5468,10528,51.94%,32.23%
0,第11案,新北市八里區,11117,5506,16623,890,17513,32970,53.12%,33.72%
0,第11案,新北市平溪區,1375,567,1942,181,2123,4321,49.13%,31.82%
0,第11案,新北市雙溪區,2499,1075,3574,328,3902,7999,48.78%,31.24%
0,第11案,新北市貢寮區,3111,1518,4629,401,5030,11279,44.6%,27.58%
0,第11案,新北市金山區,6061,2900,8961,688,9649,18978,50.84%,31.94%
0,第11案,新北市萬里區,6308,2705,9013,645,9658,19297,50.05%,32.69%
0,第11案,新北市烏來區,2001,807,2808,86,2894,5264,54.98%,38.01%
0,第11案,桃園市,605777,291473,897250,36632,933882,1801823,51.83%,33.62%
0,第11案,桃園市桃園區,114447,61960,176407,6601,183008,359790,50.87%,31.81%
0,第11案,桃園市中壢區,115927,54953,170880,6498,177378,334402,53.04%,34.67%
0,第11案,桃園市大溪區,26867,12405,39272,2276,41548,78285,53.07%,34.32%
0,第11案,桃園市楊梅區,47427,20443,67870,2644,70514,137917,51.13%,34.39%
0,第11案,桃園市蘆竹區,42768,21052,63820,2404,66224,129252,51.24%,33.09%
0,第11案,桃園市大園區,24004,11708,35712,1452,37164,73900,50.29%,32.48%
0,第11案,桃園市龜山區,40956,21628,62584,2587,65171,131702,49.48%,31.1%
0,第11案,桃園市八德區,53759,25976,79735,3777,83512,165065,50.59%,32.57%
0,第11案,桃園市龍潭區,36975,15576,52551,2070,54621,101574,53.77%,36.4%
0,第11案,桃園市平鎮區,65194,29119,94313,3617,97930,183560,53.35%,35.52%
0,第11案,桃園市新屋區,15252,6774,22026,1198,23224,41461,56.01%,36.79%
0,第11案,桃園市觀音區,18060,8670,26730,1265,27995,55149,50.76%,32.75%
0,第11案,桃園市復興區,4141,1209,5350,243,5593,9766,57.27%,42.4%
0,第11案,臺中市,868563,406665,1275228,60763,1335991,2295642,58.2%,37.84%
0,第11案,臺中市中區,5461,2373,7834,383,8217,14696,55.91%,37.16%
0,第11案,臺中市東區,24849,11683,36532,1696,38228,64291,59.46%,38.65%
0,第11案,臺中市南區,40885,20374,61259,2702,63961,103643,61.71%,39.45%
0,第11案,臺中市西區,35073,18648,53721,2119,55840,95040,58.75%,36.9%
0,第11案,臺中市北區,45623,22559,68182,2632,70814,124621,56.82%,36.61%
0,第11案,臺中市西屯區,68518,34238,102756,4187,106943,183814,58.18%,37.28%
0,第11案,臺中市南屯區,52490,26682,79172,3118,82290,135448,60.75%,38.75%
0,第11案,臺中市北屯區,85446,40801,126247,4916,131163,227720,57.6%,37.52%
0,第11案,臺中市豐原區,53764,24741,78505,3979,82484,136658,60.36%,39.34%
0,第11案,臺中市東勢區,17480,6486,23966,1495,25461,43181,58.96%,40.48%
0,第11案,臺中市大甲區,24051,10532,34583,1977,36560,63069,57.97%,38.13%
0,第11案,臺中市清水區,27102,12389,39491,2569,42060,71528,58.8%,37.89%
0,第11案,臺中市沙鹿區,27449,12792,40241,2066,42307,74207,57.01%,36.99%
0,第11案,臺中市梧棲區,17011,8468,25479,1494,26973,47040,57.34%,36.16%
0,第11案,臺中市后里區,16916,7801,24717,1491,26208,44962,58.29%,37.62%
0,第11案,臺中市神岡區,21304,9614,30918,1720,32638,54565,59.81%,39.04%
0,第11案,臺中市潭子區,34158,15445,49603,2182,51785,89487,57.87%,38.17%
0,第11案,臺中市大雅區,29388,13270,42658,1954,44612,77189,57.8%,38.07%
0,第11案,臺中市新社區,7761,2917,10678,655,11333,20860,54.33%,37.21%
0,第11案,臺中市石岡區,4924,2182,7106,531,7637,12880,59.29%,38.23%
0,第11案,臺中市外埔區,10586,4461,15047,878,15925,27059,58.85%,39.12%
0,第11案,臺中市大安區,6273,2753,9026,748,9774,16520,59.16%,37.97%
0,第11案,臺中市烏日區,23651,10951,34602,1712,36314,61705,58.85%,38.33%
0,第11案,臺中市大肚區,18118,8063,26181,1616,27797,47457,58.57%,38.18%
0,第11案,臺中市龍井區,23555,10673,34228,1830,36058,63584,56.71%,37.05%
0,第11案,臺中市霧峰區,21953,9437,31390,2097,33487,55225,60.64%,39.75%
0,第11案,臺中市太平區,57059,25896,82955,3799,86754,157926,54.93%,36.13%
0,第11案,臺中市大里區,63580,28967,92547,3890,96437,171769,56.14%,37.01%
0,第11案,臺中市和平區,4135,1469,5604,327,5931,9498,62.44%,43.54%
0,第11案,臺南市,537623,254622,792245,39589,831834,1594821,52.16%,33.71%
0,第11案,臺南市新營區,21028,10123,31151,1675,32826,64949,50.54%,32.38%
0,第11案,臺南市鹽水區,6910,3187,10097,745,10842,22121,49.01%,31.24%
0,第11案,臺南市白河區,7052,3223,10275,873,11148,24894,44.78%,28.33%
0,第11案,臺南市柳營區,6119,2643,8762,733,9495,18804,50.49%,32.54%
0,第11案,臺南市後壁區,6350,2695,9045,847,9892,20841,47.46%,30.47%
0,第11案,臺南市東山區,4753,1967,6720,580,7300,18471,39.52%,25.73%
0,第11案,臺南市麻豆區,12006,6114,18120,948,19068,37963,50.23%,31.63%
0,第11案,臺南市下營區,6638,2777,9415,683,10098,20947,48.21%,31.69%
0,第11案,臺南市六甲區,5759,2850,8609,710,9319,19144,48.68%,30.08%
0,第11案,臺南市官田區,5914,2786,8700,632,9332,18675,49.97%,31.67%
0,第11案,臺南市大內區,2824,1111,3935,334,4269,8654,49.33%,32.63%
0,第11案,臺南市佳里區,17476,7728,25204,1549,26753,50407,53.07%,34.67%
0,第11案,臺南市學甲區,7157,3174,10331,600,10931,22567,48.44%,31.71%
0,第11案,臺南市西港區,6625,3138,9763,552,10315,21564,47.83%,30.72%
0,第11案,臺南市七股區,6592,2505,9097,565,9662,19950,48.43%,33.04%
0,第11案,臺南市將軍區,5782,2179,7961,505,8466,17754,47.69%,32.57%
0,第11案,臺南市北門區,2877,1136,4013,245,4258,9925,42.9%,28.99%
0,第11案,臺南市新化區,13367,5896,19263,1024,20287,37296,54.39%,35.84%
0,第11案,臺南市善化區,13383,6569,19952,933,20885,39950,52.28%,33.5%
0,第11案,臺南市新市區,10824,4984,15808,673,16481,30386,54.24%,35.62%
0,第11案,臺南市安定區,9457,4068,13525,748,14273,26104,54.68%,36.23%
0,第11案,臺南市山上區,1895,874,2769,165,2934,6511,45.06%,29.1%
0,第11案,臺南市玉井區,4277,1474,5751,388,6139,12357,49.68%,34.61%
0,第11案,臺南市楠西區,2651,998,3649,265,3914,8528,45.9%,31.09%
0,第11案,臺南市南化區,2436,1020,3456,278,3734,7786,47.96%,31.29%
0,第11案,臺南市左鎮區,1429,492,1921,153,2074,4418,46.94%,32.34%
0,第11案,臺南市仁德區,23066,10194,33260,1673,34933,64632,54.05%,35.69%
0,第11案,臺南市歸仁區,19859,9577,29436,1448,30884,57387,53.82%,34.61%
0,第11案,臺南市關廟區,10491,4801,15292,999,16291,29913,54.46%,35.07%
0,第11案,臺南市龍崎區,1246,474,1720,146,1866,3713,50.26%,33.56%
0,第11案,臺南市永康區,66331,32457,98788,3609,102397,195001,52.51%,34.02%
0,第11案,臺南市東區,53914,27491,81405,3074,84479,153359,55.09%,35.16%
0,第11案,臺南市南區,36989,17349,54338,2377,56715,108650,52.2%,34.04%
0,第11案,臺南市北區,38923,19106,58029,2351,60380,110906,54.44%,35.1%
0,第11案,臺南市安南區,54063,26146,80209,4033,84242,159654,52.77%,33.86%
0,第11案,臺南市安平區,18147,9409,27556,835,28391,55379,51.27%,32.77%
0,第11案,臺南市中西區,23013,11907,34920,1641,36561,65261,56.02%,35.26%
0,第11案,高雄市,934858,413374,1348232,58167,1406399,2353342,59.76%,39.72%
0,第11案,高雄市鹽埕區,8291,4133,12424,457,12881,21617,59.59%,38.35%
0,第11案,高雄市鼓山區,46387,20737,67124,2272,69396,114979,60.36%,40.34%
0,第11案,高雄市左營區,66941,29138,96079,3098,99177,161367,61.46%,41.48%
0,第11案,高雄市楠梓區,61146,26996,88142,3731,91873,153132,60%,39.93%
0,第11案,高雄市三民區,114862,54188,169050,5602,174652,289519,60.32%,39.67%
0,第11案,高雄市新興區,17782,8806,26588,958,27546,44355,62.1%,40.09%
0,第11案,高雄市前金區,9711,4547,14258,553,14811,23928,61.9%,40.58%
0,第11案,高雄市苓雅區,60784,27867,88651,3234,91885,146786,62.6%,41.41%
0,第11案,高雄市前鎮區,63672,28519,92191,4237,96428,161797,59.6%,39.35%
0,第11案,高雄市旗津區,9013,3854,12867,663,13530,24860,54.42%,36.26%
0,第11案,高雄市小港區,52471,23338,75809,3205,79014,132733,59.53%,39.53%
0,第11案,高雄市鳳山區,121790,53188,174978,6400,181378,300510,60.36%,40.53%
0,第11案,高雄市林園區,21650,9762,31412,1728,33140,59129,56.05%,36.61%
0,第11案,高雄市大寮區,38167,15802,53969,2822,56791,97309,58.36%,39.22%
0,第11案,高雄市大樹區,13883,5704,19587,1216,20803,36772,56.57%,37.75%
0,第11案,高雄市大社區,11060,5656,16716,789,17505,30046,58.26%,36.81%
0,第11案,高雄市仁武區,29527,12770,42297,1475,43772,73611,59.46%,40.11%
0,第11案,高雄市鳥松區,15786,7300,23086,1011,24097,39191,61.49%,40.28%
0,第11案,高雄市岡山區,34306,14078,48384,2165,50549,81244,62.22%,42.23%
0,第11案,高雄市橋頭區,13696,5911,19607,1066,20673,32565,63.48%,42.06%
0,第11案,高雄市燕巢區,9918,4252,14170,907,15077,26012,57.96%,38.13%
0,第11案,高雄市田寮區,2120,895,3015,281,3296,6671,49.41%,31.78%
0,第11案,高雄市阿蓮區,8913,3926,12839,667,13506,24534,55.05%,36.33%
0,第11案,高雄市路竹區,17063,7678,24741,1465,26206,43850,59.76%,38.91%
0,第11案,高雄市湖內區,9636,4230,13866,723,14589,25729,56.7%,37.45%
0,第11案,高雄市茄萣區,9593,3958,13551,870,14421,26212,55.02%,36.6%
0,第11案,高雄市永安區,5024,2184,7208,425,7633,12001,63.6%,41.86%
0,第11案,高雄市彌陀區,6857,2749,9606,631,10237,16487,62.09%,41.59%
0,第11案,高雄市梓官區,12908,4912,17820,882,18702,31025,60.28%,41.61%
0,第11案,高雄市旗山區,11950,5192,17142,1199,18341,31996,57.32%,37.35%
0,第11案,高雄市美濃區,13222,4696,17918,1573,19491,35311,55.2%,37.44%
0,第11案,高雄市六龜區,3535,1464,4999,554,5553,11501,48.28%,30.74%
0,第11案,高雄市甲仙區,1740,736,2476,268,2744,5417,50.66%,32.12%
0,第11案,高雄市杉林區,3336,1323,4659,372,5031,10607,47.43%,31.45%
0,第11案,高雄市內門區,4380,1717,6097,461,6558,13002,50.44%,33.69%
0,第11案,高雄市茂林區,812,263,1075,53,1128,1615,69.85%,50.28%
0,第11案,高雄市桃源區,1615,547,2162,61,2223,3498,63.55%,46.17%
0,第11案,高雄市那瑪夏區,1311,358,1669,93,1762,2424,72.69%,54.08%
0,第11案,新竹縣,168550,75167,243717,10127,253844,445051,57.04%,37.87%
0,第11案,新竹縣竹北市,51290,26410,77700,2476,80176,137129,58.47%,37.4%
0,第11案,新竹縣竹東鎮,28870,12312,41182,1681,42863,78794,54.4%,36.64%
0,第11案,新竹縣新埔鎮,10885,4581,15466,863,16329,28894,56.51%,37.67%
0,第11案,新竹縣關西鎮,9618,3802,13420,717,14137,24712,57.21%,38.92%
0,第11案,新竹縣湖口鄉,24223,10192,34415,1399,35814,63511,56.39%,38.14%
0,第11案,新竹縣新豐鄉,17326,7381,24707,1014,25721,45790,56.17%,37.84%
0,第11案,新竹縣芎林鄉,6800,2943,9743,493,10236,17293,59.19%,39.32%
0,第11案,新竹縣橫山鄉,4589,1707,6296,426,6722,11346,59.25%,40.45%
0,第11案,新竹縣北埔鄉,3132,1308,4440,218,4658,8180,56.94%,38.29%
0,第11案,新竹縣寶山鄉,4929,2292,7221,408,7629,12973,58.81%,37.99%
0,第11案,新竹縣峨眉鄉,2098,769,2867,208,3075,5068,60.67%,41.4%
0,第11案,新竹縣尖石鄉,3206,938,4144,150,4294,7364,58.31%,43.54%
0,第11案,新竹縣五峰鄉,1584,532,2116,74,2190,3997,54.79%,39.63%
0,第11案,苗栗縣,175397,74340,249737,13713,263450,461580,57.08%,38%
0,第11案,苗栗縣苗栗市,29311,11785,41096,1864,42960,74249,57.86%,39.48%
0,第11案,苗栗縣苑裡鎮,14746,6423,21169,1276,22445,38890,57.71%,37.92%
0,第11案,苗栗縣通霄鎮,10718,4625,15343,995,16338,29709,54.99%,36.08%
0,第11案,苗栗縣竹南鎮,25657,11311,36968,1650,38618,68528,56.35%,37.44%
0,第11案,苗栗縣頭份市,32171,13439,45610,1974,47584,83617,56.91%,38.47%
0,第11案,苗栗縣後龍鎮,10907,5134,16041,1123,17164,30948,55.46%,35.24%
0,第11案,苗栗縣卓蘭鎮,5637,2514,8151,529,8680,14772,58.76%,38.16%
0,第11案,苗栗縣大湖鄉,4454,1872,6326,445,6771,12653,53.51%,35.2%
0,第11案,苗栗縣公館鄉,10842,4804,15646,1089,16735,28318,59.1%,38.29%
0,第11案,苗栗縣銅鑼鄉,5749,2363,8112,546,8658,15424,56.13%,37.27%
0,第11案,苗栗縣南庄鄉,2800,1253,4053,297,4350,8784,49.52%,31.88%
0,第11案,苗栗縣頭屋鄉,4268,1522,5790,325,6115,9390,65.12%,45.45%
0,第11案,苗栗縣三義鄉,5554,2183,7737,418,8155,13889,58.72%,39.99%
0,第11案,苗栗縣西湖鄉,2341,983,3324,224,3548,6382,55.59%,36.68%
0,第11案,苗栗縣造橋鄉,4225,1791,6016,420,6436,11027,58.37%,38.32%
0,第11案,苗栗縣三灣鄉,2215,927,3142,238,3380,5852,57.76%,37.85%
0,第11案,苗栗縣獅潭鄉,1402,486,1888,154,2042,3968,51.46%,35.33%
0,第11案,苗栗縣泰安鄉,2400,925,3325,146,3471,5180,67.01%,46.33%
0,第11案,彰化縣,404865,177099,581964,33576,615540,1066994,57.69%,37.94%
0,第11案,彰化縣彰化市,76438,34580,111018,4959,115977,190995,60.72%,40.02%
0,第11案,彰化縣鹿港鎮,27150,11839,38989,2260,41249,70505,58.51%,38.51%
0,第11案,彰化縣和美鎮,28171,12933,41104,1937,43041,75286,57.17%,37.42%
0,第11案,彰化縣線西鄉,5502,2363,7865,563,8428,14065,59.92%,39.12%
0,第11案,彰化縣伸港鄉,11059,5132,16191,1028,17219,30407,56.63%,36.37%
0,第11案,彰化縣福興鄉,14430,5939,20369,1303,21672,39745,54.53%,36.31%
0,第11案,彰化縣秀水鄉,12650,5582,18232,1063,19295,32394,59.56%,39.05%
0,第11案,彰化縣花壇鄉,15812,6438,22250,1024,23274,38924,59.79%,40.62%
0,第11案,彰化縣芬園鄉,7522,3102,10624,734,11358,20408,55.65%,36.86%
0,第11案,彰化縣員林市,38409,17556,55965,2342,58307,102028,57.15%,37.65%
0,第11案,彰化縣溪湖鎮,17125,7662,24787,1425,26212,45147,58.06%,37.93%
0,第11案,彰化縣田中鎮,13537,5892,19429,1116,20545,35391,58.05%,38.25%
0,第11案,彰化縣大村鄉,12091,5404,17495,1069,18564,31492,58.95%,38.39%
0,第11案,彰化縣埔鹽鄉,11384,4379,15763,1180,16943,28026,60.45%,40.62%
0,第11案,彰化縣埔心鄉,11880,5347,17227,1107,18334,29642,61.85%,40.08%
0,第11案,彰化縣永靖鄉,12176,5389,17565,1112,18677,31239,59.79%,38.98%
0,第11案,彰化縣社頭鄉,14152,5816,19968,1071,21039,36306,57.95%,38.98%
0,第11案,彰化縣二水鄉,5450,2119,7569,545,8114,13339,60.83%,40.86%
0,第11案,彰化縣北斗鎮,10868,4308,15176,956,16132,27593,58.46%,39.39%
0,第11案,彰化縣二林鎮,15018,6114,21132,1552,22684,42976,52.78%,34.95%
0,第11案,彰化縣田尾鄉,8969,3949,12918,891,13809,23179,59.58%,38.69%
0,第11案,彰化縣埤頭鄉,8843,4208,13051,1048,14099,25677,54.91%,34.44%
0,第11案,彰化縣芳苑鄉,9516,3827,13343,1210,14553,29291,49.68%,32.49%
0,第11案,彰化縣大城鄉,3724,1500,5224,493,5717,14713,38.86%,25.31%
0,第11案,彰化縣竹塘鄉,4362,2048,6410,622,7032,12821,54.85%,34.02%
0,第11案,彰化縣溪州鄉,8627,3673,12300,966,13266,25405,52.22%,33.96%
0,第11案,南投縣,165850,68818,234668,13875,248543,427089,58.19%,38.83%
0,第11案,南投縣南投市,34407,14480,48887,2254,51141,84328,60.65%,40.8%
0,第11案,南投縣埔里鎮,26111,11041,37152,2346,39498,68763,57.44%,37.97%
0,第11案,南投縣草屯鎮,31801,14221,46022,2280,48302,82922,58.25%,38.35%
0,第11案,南投縣竹山鎮,17492,7053,24545,1663,26208,47034,55.72%,37.19%
0,第11案,南投縣集集鎮,3586,1648,5234,355,5589,9611,58.15%,37.31%
0,第11案,南投縣名間鄉,13206,5577,18783,1352,20135,33408,60.27%,39.53%
0,第11案,南投縣鹿谷鄉,5692,2331,8023,595,8618,15941,54.06%,35.71%
0,第11案,南投縣中寮鄉,5044,2026,7070,587,7657,13181,58.09%,38.27%
0,第11案,南投縣魚池鄉,4991,2126,7117,511,7628,13958,54.65%,35.76%
0,第11案,南投縣國姓鄉,6299,2465,8764,612,9376,16597,56.49%,37.95%
0,第11案,南投縣水里鄉,5746,2368,8114,538,8652,15458,55.97%,37.17%
0,第11案,南投縣信義鄉,6243,1740,7983,491,8474,13299,63.72%,46.94%
0,第11案,南投縣仁愛鄉,5232,1742,6974,291,7265,12589,57.71%,41.56%
0,第11案,雲林縣,196214,88271,284485,20234,304719,584480,52.14%,33.57%
0,第11案,雲林縣斗六市,33938,15650,49588,2140,51728,89761,57.63%,37.81%
0,第11案,雲林縣斗南鎮,14373,6241,20614,1261,21875,38138,57.36%,37.69%
0,第11案,雲林縣虎尾鎮,20035,9568,29603,1552,31155,58167,53.56%,34.44%
0,第11案,雲林縣西螺鎮,12953,6017,18970,1440,20410,38142,53.51%,33.96%
0,第11案,雲林縣土庫鎮,8315,3744,12059,990,13049,24412,53.45%,34.06%
0,第11案,雲林縣北港鎮,11976,5371,17347,1286,18633,33958,54.87%,35.27%
0,第11案,雲林縣古坑鄉,9531,4178,13709,954,14663,27477,53.36%,34.69%
0,第11案,雲林縣大埤鄉,5518,2526,8044,577,8621,16509,52.22%,33.42%
0,第11案,雲林縣莿桐鄉,8646,3946,12592,1037,13629,24570,55.47%,35.19%
0,第11案,雲林縣林內鄉,5670,2494,8164,676,8840,15551,56.85%,36.46%
0,第11案,雲林縣二崙鄉,6969,3256,10225,1037,11262,23367,48.2%,29.82%
0,第11案,雲林縣崙背鄉,6639,2894,9533,816,10349,21050,49.16%,31.54%
0,第11案,雲林縣麥寮鄉,11773,5253,17026,1267,18293,37119,49.28%,31.72%
0,第11案,雲林縣東勢鄉,4225,1866,6091,527,6618,13239,49.99%,31.91%
0,第11案,雲林縣褒忠鄉,3677,1798,5475,395,5870,11381,51.58%,32.31%
0,第11案,雲林縣臺西鄉,6443,2561,9004,770,9774,21125,46.27%,30.5%
0,第11案,雲林縣元長鄉,6424,2790,9214,798,10012,22830,43.85%,28.14%
0,第11案,雲林縣四湖鄉,5432,2260,7692,712,8404,20983,40.05%,25.89%
0,第11案,雲林縣口湖鄉,7386,3160,10546,1103,11649,24193,48.15%,30.53%
0,第11案,雲林縣水林鄉,6291,2698,8989,896,9885,22508,43.92%,27.95%
0,第11案,嘉義縣,148475,64207,212682,15372,228054,442775,51.51%,33.53%
0,第11案,嘉義縣太保市,11095,5051,16146,1019,17165,31568,54.37%,35.15%
0,第11案,嘉義縣朴子市,11894,5250,17144,1245,18389,35191,52.25%,33.8%
0,第11案,嘉義縣布袋鎮,7832,3134,10966,838,11804,23965,49.26%,32.68%
0,第11案,嘉義縣大林鎮,9104,4064,13168,1008,14176,26922,52.66%,33.82%
0,第11案,嘉義縣民雄鄉,21384,9645,31029,2011,33040,61209,53.98%,34.94%
0,第11案,嘉義縣溪口鄉,4582,1735,6317,549,6866,13105,52.39%,34.96%
0,第11案,嘉義縣新港鄉,9438,4225,13663,1326,14989,27342,54.82%,34.52%
0,第11案,嘉義縣六腳鄉,5883,2405,8288,744,9032,20821,43.38%,28.26%
0,第11案,嘉義縣東石鄉,6163,2341,8504,711,9215,21915,42.05%,28.12%
0,第11案,嘉義縣義竹鄉,5456,2316,7772,753,8525,16647,51.21%,32.77%
0,第11案,嘉義縣鹿草鄉,4061,1849,5910,617,6527,13937,46.83%,29.14%
0,第11案,嘉義縣水上鄉,15297,6915,22212,1350,23562,43857,53.72%,34.88%
0,第11案,嘉義縣中埔鄉,12230,5403,17633,1031,18664,39139,47.69%,31.25%
0,第11案,嘉義縣竹崎鄉,11132,4513,15645,851,16496,31228,52.82%,35.65%
0,第11案,嘉義縣梅山鄉,6165,2683,8848,664,9512,17083,55.68%,36.09%
0,第11案,嘉義縣番路鄉,3791,1470,5261,435,5696,10156,56.09%,37.33%
0,第11案,嘉義縣大埔鄉,1457,613,2070,126,2196,3999,54.91%,36.43%
0,第11案,嘉義縣阿里山鄉,1511,595,2106,94,2200,4691,46.9%,32.21%
0,第11案,屏東縣,244464,110273,354737,22276,377013,711720,52.97%,34.35%
0,第11案,屏東縣屏東市,59826,27326,87152,3688,90840,170148,53.39%,35.16%
0,第11案,屏東縣潮州鎮,16355,6934,23289,1169,24458,46444,52.66%,35.21%
0,第11案,屏東縣東港鎮,13670,6084,19754,1405,21159,39495,53.57%,34.61%
0,第11案,屏東縣恆春鎮,7601,3748,11349,750,12099,25661,47.15%,29.62%
0,第11案,屏東縣萬丹鄉,15225,6826,22051,1443,23494,43478,54.04%,35.02%
0,第11案,屏東縣長治鄉,9356,4260,13616,895,14511,26256,55.27%,35.63%
0,第11案,屏東縣麟洛鄉,3670,1913,5583,283,5866,9970,58.84%,36.81%
0,第11案,屏東縣九如鄉,6634,3021,9655,793,10448,19132,54.61%,34.67%
0,第11案,屏東縣里港鄉,7569,3695,11264,952,12216,22128,55.21%,34.21%
0,第11案,屏東縣鹽埔鄉,7456,3572,11028,773,11801,22402,52.68%,33.28%
0,第11案,屏東縣高樹鄉,6623,3300,9923,928,10851,21697,50.01%,30.52%
0,第11案,屏東縣萬巒鄉,6179,2566,8745,630,9375,17945,52.24%,34.43%
0,第11案,屏東縣內埔鄉,15255,6597,21852,1282,23134,47558,48.64%,32.08%
0,第11案,屏東縣竹田鄉,5613,2696,8309,672,8981,15353,58.5%,36.56%
0,第11案,屏東縣新埤鄉,2876,1332,4208,381,4589,9033,50.8%,31.84%
0,第11案,屏東縣枋寮鄉,7401,3213,10614,900,11514,21394,53.82%,34.59%
0,第11案,屏東縣新園鄉,10302,4796,15098,1184,16282,30706,53.03%,33.55%
0,第11案,屏東縣崁頂鄉,4115,1955,6070,422,6492,12270,52.91%,33.54%
0,第11案,屏東縣林邊鄉,5745,2409,8154,677,8831,15691,56.28%,36.61%
0,第11案,屏東縣南州鄉,3161,1531,4692,417,5109,9479,53.9%,33.35%
0,第11案,屏東縣佳冬鄉,5306,2532,7838,717,8555,17063,50.14%,31.1%
0,第11案,屏東縣琉球鄉,3222,1192,4414,341,4755,10706,44.41%,30.1%
0,第11案,屏東縣車城鄉,1901,1063,2964,239,3203,7595,42.17%,25.03%
0,第11案,屏東縣滿州鄉,1923,979,2902,148,3050,7206,42.33%,26.69%
0,第11案,屏東縣枋山鄉,1618,740,2358,176,2534,4856,52.18%,33.32%
0,第11案,屏東縣三地門鄉,2700,1086,3786,199,3985,6373,62.53%,42.37%
0,第11案,屏東縣霧臺鄉,1628,548,2176,75,2251,2950,76.31%,55.19%
0,第11案,屏東縣瑪家鄉,2625,924,3549,129,3678,5663,64.95%,46.35%
0,第11案,屏東縣泰武鄉,1967,782,2749,148,2897,4344,66.69%,45.28%
0,第11案,屏東縣來義鄉,2652,928,3580,225,3805,6257,60.81%,42.38%
0,第11案,屏東縣春日鄉,1141,552,1693,50,1743,3923,44.43%,29.08%
0,第11案,屏東縣獅子鄉,1938,615,2553,103,2656,4230,62.79%,45.82%
0,第11案,屏東縣牡丹鄉,1211,558,1769,82,1851,4314,42.91%,28.07%
0,第11案,宜蘭縣,136422,67663,204085,12028,216113,386089,55.97%,35.33%
0,第11案,宜蘭縣宜蘭市,28367,14687,43054,2099,45153,79167,57.04%,35.83%
0,第11案,宜蘭縣羅東鎮,20888,10793,31681,1618,33299,57686,57.72%,36.21%
0,第11案,宜蘭縣蘇澳鎮,12078,5794,17872,1418,19290,34512,55.89%,35%
0,第11案,宜蘭縣頭城鎮,8612,4223,12835,1004,13839,25135,55.06%,34.26%
0,第11案,宜蘭縣礁溪鄉,10409,5498,15907,970,16877,31084,54.29%,33.49%
0,第11案,宜蘭縣壯圍鄉,7858,3818,11676,868,12544,21447,58.49%,36.64%
0,第11案,宜蘭縣員山鄉,9477,4864,14341,968,15309,28131,54.42%,33.69%
0,第11案,宜蘭縣冬山鄉,15402,7791,23193,1246,24439,45405,53.82%,33.92%
0,第11案,宜蘭縣五結鄉,11876,5992,17868,967,18835,34892,53.98%,34.04%
0,第11案,宜蘭縣三星鄉,6484,3005,9489,588,10077,19051,52.89%,34.03%
0,第11案,宜蘭縣大同鄉,2772,647,3419,138,3557,4935,72.08%,56.17%
0,第11案,宜蘭縣南澳鄉,2199,551,2750,144,2894,4644,62.32%,47.35%
0,第11案,花蓮縣,99444,40126,139570,8244,147814,278059,53.16%,35.76%
0,第11案,花蓮縣花蓮市,30824,12989,43813,1967,45780,84807,53.98%,36.35%
0,第11案,花蓮縣鳳林鎮,3595,1381,4976,407,5383,9676,55.63%,37.15%
0,第11案,花蓮縣玉里鎮,6862,2490,9352,784,10136,20650,49.08%,33.23%
0,第11案,花蓮縣新城鄉,6304,2510,8814,464,9278,17029,54.48%,37.02%
0,第11案,花蓮縣吉安鄉,25828,10468,36296,1867,38163,72116,52.92%,35.81%
0,第11案,花蓮縣壽豐鄉,5779,2394,8173,651,8824,15847,55.68%,36.47%
0,第11案,花蓮縣光復鄉,4121,1485,5606,469,6075,11417,53.21%,36.1%
0,第11案,花蓮縣豐濱鄉,1447,592,2039,135,2174,4395,49.47%,32.92%
0,第11案,花蓮縣瑞穗鄉,3545,1299,4844,387,5231,10279,50.89%,34.49%
0,第11案,花蓮縣富里鄉,2600,1144,3744,410,4154,9065,45.82%,28.68%
0,第11案,花蓮縣秀林鄉,4352,1869,6221,340,6561,12562,52.23%,34.64%
0,第11案,花蓮縣萬榮鄉,2116,824,2940,178,3118,5269,59.18%,40.16%
0,第11案,花蓮縣卓溪鄉,2071,681,2752,185,2937,4947,59.37%,41.86%
0,第11案,臺東縣,65985,26076,92061,5202,97263,185996,52.29%,35.48%
0,第11案,臺東縣臺東市,32943,13026,45969,1978,47947,87803,54.61%,37.52%
0,第11案,臺東縣成功鎮,4334,1480,5814,475,6289,12426,50.61%,34.88%
0,第11案,臺東縣關山鎮,2490,1051,3541,202,3743,7509,49.85%,33.16%
0,第11案,臺東縣卑南鄉,5194,2153,7347,560,7907,14976,52.8%,34.68%
0,第11案,臺東縣鹿野鄉,1975,932,2907,226,3133,6936,45.17%,28.47%
0,第11案,臺東縣池上鄉,2041,940,2981,309,3290,7162,45.94%,28.5%
0,第11案,臺東縣東河鄉,2281,843,3124,269,3393,7635,44.44%,29.88%
0,第11案,臺東縣長濱鄉,1872,691,2563,243,2806,6484,43.28%,28.87%
0,第11案,臺東縣太麻里鄉,3792,1252,5044,314,5358,9666,55.43%,39.23%
0,第11案,臺東縣大武鄉,1874,712,2586,192,2778,5266,52.75%,35.59%
0,第11案,臺東縣綠島鄉,1048,489,1537,52,1589,3579,44.4%,29.28%
0,第11案,臺東縣海端鄉,1215,482,1697,76,1773,3278,54.09%,37.07%
0,第11案,臺東縣延平鄉,1176,462,1638,63,1701,2930,58.05%,40.14%
0,第11案,臺東縣金峰鄉,1425,492,1917,88,2005,3028,66.22%,47.06%
0,第11案,臺東縣達仁鄉,1326,471,1797,83,1880,3137,59.93%,42.27%
0,第11案,臺東縣蘭嶼鄉,999,600,1599,72,1671,4181,39.97%,23.89%
0,第11案,澎湖縣,27546,11418,38964,2193,41157,90405,45.53%,30.47%
0,第11案,澎湖縣馬公市,17651,7463,25114,1229,26343,53655,49.1%,32.9%
0,第11案,澎湖縣湖西鄉,3855,1456,5311,319,5630,12741,44.19%,30.26%
0,第11案,澎湖縣白沙鄉,2506,961,3467,230,3697,8625,42.86%,29.06%
0,第11案,澎湖縣西嶼鄉,1620,678,2298,252,2550,7382,34.54%,21.95%
0,第11案,澎湖縣望安鄉,1270,535,1805,105,1910,4628,41.27%,27.44%
0,第11案,澎湖縣七美鄉,644,325,969,58,1027,3374,30.44%,19.09%
0,第11案,金門縣,30593,11206,41799,2129,43928,122695,35.8%,24.93%
0,第11案,金門縣金城鎮,9373,3247,12620,626,13246,37815,35.03%,24.79%
0,第11案,金門縣金沙鎮,4856,1367,6223,350,6573,18560,35.41%,26.16%
0,第11案,金門縣金湖鎮,6676,2333,9009,485,9494,25915,36.64%,25.76%
0,第11案,金門縣金寧鄉,6500,3260,9760,435,10195,28162,36.2%,23.08%
0,第11案,金門縣烈嶼鄉,3063,965,4028,227,4255,11676,36.44%,26.23%
0,第11案,金門縣烏坵鄉,125,34,159,6,165,567,29.1%,22.05%
0,第11案,連江縣,4131,1461,5592,195,5787,11205,51.65%,36.87%
0,第11案,連江縣南竿鄉,2385,796,3181,104,3285,6461,50.84%,36.91%
0,第11案,連江縣北竿鄉,802,270,1072,38,1110,2125,52.24%,37.74%
0,第11案,連江縣莒光鄉,544,225,769,37,806,1481,54.42%,36.73%
0,第11案,連江縣東引鄉,400,170,570,16,586,1138,51.49%,35.15%
0,第11案,基隆市,106801,52811,159612,6826,166438,320030,52.01%,33.37%
0,第11案,基隆市中正區,13964,6670,20634,1086,21720,45545,47.69%,30.66%
0,第11案,基隆市七堵區,15867,7761,23628,1044,24672,46256,53.34%,34.3%
0,第11案,基隆市暖暖區,11394,5797,17191,575,17766,33225,53.47%,34.29%
0,第11案,基隆市仁愛區,12588,6081,18669,1020,19689,36738,53.59%,34.26%
0,第11案,基隆市中山區,13795,6824,20619,933,21552,41856,51.49%,32.96%
0,第11案,基隆市安樂區,23424,11849,35273,1319,36592,70396,51.98%,33.27%
0,第11案,基隆市信義區,15769,7829,23598,849,24447,46014,53.13%,34.27%
0,第11案,新竹市,127376,65250,192626,7741,200367,351775,56.96%,36.21%
0,第11案,新竹市東區,58811,31895,90706,3309,94015,163757,57.41%,35.91%
0,第11案,新竹市北區,44836,21959,66795,2770,69565,123122,56.5%,36.42%
0,第11案,新竹市香山區,23729,11396,35125,1662,36787,64896,56.69%,36.56%
0,第11案,嘉義市,80216,38442,118658,4412,123070,221553,55.55%,36.21%
0,第11案,嘉義市東區,36166,17641,53807,1882,55689,100647,55.33%,35.93%
0,第11案,嘉義市西區,44050,20801,64851,2530,67381,120906,55.73%,36.43%
0,第12案,全國,6401748,4072471,10474219,540757,11014976,19757067,55.75%,32.4%
0,第12案,臺北市,732239,506433,1238672,55460,1294132,2228430,58.07%,32.86%
0,第12案,臺北市松山區,57656,38733,96389,4247,100636,169278,59.45%,34.06%
0,第12案,臺北市信義區,62853,43324,106177,4836,111013,190444,58.29%,33%
0,第12案,臺北市大安區,83730,56964,140694,5604,146298,252645,57.91%,33.14%
0,第12案,臺北市中山區,62130,44981,107111,4939,112050,195148,57.42%,31.84%
0,第12案,臺北市中正區,42868,29334,72202,3032,75234,128292,58.64%,33.41%
0,第12案,臺北市大同區,34138,25407,59545,3208,62753,107557,58.34%,31.74%
0,第12案,臺北市萬華區,50898,36257,87155,4721,91876,164020,56.02%,31.03%
0,第12案,臺北市文山區,78865,51554,130419,5657,136076,227211,59.89%,34.71%
0,第12案,臺北市南港區,33203,23931,57134,2300,59434,101907,58.32%,32.58%
0,第12案,臺北市內湖區,79459,54312,133771,4990,138761,236824,58.59%,33.55%
0,第12案,臺北市士林區,78172,54400,132572,6590,139162,241854,57.54%,32.32%
0,第12案,臺北市北投區,68267,47236,115503,5336,120839,213250,56.67%,32.01%
0,第12案,新北市,1070300,712548,1782848,92282,1875130,3375513,55.55%,31.71%
0,第12案,新北市板橋區,153500,98590,252090,12520,264610,463411,57.1%,33.12%
0,第12案,新北市三重區,101972,72085,174057,10832,184889,329846,56.05%,30.92%
0,第12案,新北市中和區,117533,72733,190266,8702,198968,355978,55.89%,33.02%
0,第12案,新北市永和區,65391,41209,106600,4783,111383,187798,59.31%,34.82%
0,第12案,新北市新莊區,111089,76839,187928,9684,197612,344981,57.28%,32.2%
0,第12案,新北市新店區,88798,54809,143607,6412,150019,264053,56.81%,33.63%
0,第12案,新北市樹林區,47189,32946,80135,4367,84502,152102,55.56%,31.02%
0,第12案,新北市鶯歌區,21315,14996,36311,1824,38135,71645,53.23%,29.75%
0,第12案,新北市三峽區,28622,18860,47482,2425,49907,94291,52.93%,30.35%
0,第12案,新北市淡水區,44720,29981,74701,3366,78067,147272,53.01%,30.37%
0,第12案,新北市汐止區,52092,35719,87811,4490,92301,173831,53.1%,29.97%
0,第12案,新北市瑞芳區,9374,6355,15729,1230,16959,35036,48.4%,26.76%
0,第12案,新北市土城區,62655,42571,105226,5597,110823,200783,55.2%,31.21%
0,第12案,新北市蘆洲區,49602,35657,85259,4595,89854,167457,53.66%,29.62%
0,第12案,新北市五股區,22210,14665,36875,2067,38942,72443,53.76%,30.66%
0,第12案,新北市泰山區,20423,13613,34036,1602,35638,64252,55.47%,31.79%
0,第12案,新北市林口區,27446,18805,46251,2146,48397,86203,56.14%,31.84%
0,第12案,新北市深坑區,6399,4483,10882,607,11489,20624,55.71%,31.03%
0,第12案,新北市石碇區,1895,1359,3254,273,3527,6861,51.41%,27.62%
0,第12案,新北市坪林區,1714,1089,2803,230,3033,5891,51.49%,29.1%
0,第12案,新北市三芝區,5384,3787,9171,653,9824,20119,48.83%,26.76%
0,第12案,新北市石門區,2955,2092,5047,420,5467,10528,51.93%,28.07%
0,第12案,新北市八里區,9599,6978,16577,952,17529,32970,53.17%,29.11%
0,第12案,新北市平溪區,1218,703,1921,197,2118,4321,49.02%,28.19%
0,第12案,新北市雙溪區,2122,1476,3598,311,3909,7999,48.87%,26.53%
0,第12案,新北市貢寮區,2649,1939,4588,452,5040,11279,44.68%,23.49%
0,第12案,新北市金山區,5228,3653,8881,753,9634,18978,50.76%,27.55%
0,第12案,新北市萬里區,5433,3538,8971,694,9665,19297,50.09%,28.15%
0,第12案,新北市烏來區,1773,1018,2791,98,2889,5264,54.88%,33.68%
0,第12案,桃園市,540236,352795,893031,40531,933562,1801823,51.81%,29.98%
0,第12案,桃園市桃園區,104081,71688,175769,7425,183194,359790,50.92%,28.93%
0,第12案,桃園市中壢區,104348,65472,169820,7067,176887,334402,52.9%,31.2%
0,第12案,桃園市大溪區,23559,15578,39137,2367,41504,78285,53.02%,30.09%
0,第12案,桃園市楊梅區,41994,25313,67307,2989,70296,137917,50.97%,30.45%
0,第12案,桃園市蘆竹區,38396,25321,63717,2654,66371,129252,51.35%,29.71%
0,第12案,桃園市大園區,20740,14918,35658,1561,37219,73900,50.36%,28.06%
0,第12案,桃園市龜山區,36552,25742,62294,2890,65184,131702,49.49%,27.75%
0,第12案,桃園市八德區,47532,31746,79278,4186,83464,165065,50.56%,28.8%
0,第12案,桃園市龍潭區,33953,18573,52526,2211,54737,101574,53.89%,33.43%
0,第12案,桃園市平鎮區,57526,36277,93803,4065,97868,183560,53.32%,31.34%
0,第12案,桃園市新屋區,12741,9152,21893,1322,23215,41461,55.99%,30.73%
0,第12案,桃園市觀音區,15302,11210,26512,1509,28021,55149,50.81%,27.75%
0,第12案,桃園市復興區,3512,1805,5317,285,5602,9766,57.36%,35.96%
0,第12案,臺中市,777273,490959,1268232,68562,1336794,2295642,58.23%,33.86%
0,第12案,臺中市中區,4828,3021,7849,483,8332,14696,56.7%,32.85%
0,第12案,臺中市東區,22105,14057,36162,1954,38116,64291,59.29%,34.38%
0,第12案,臺中市南區,37710,23028,60738,3118,63856,103643,61.61%,36.38%
0,第12案,臺中市西區,32508,20953,53461,2515,55976,95040,58.9%,34.2%
0,第12案,臺中市北區,41580,26168,67748,3069,70817,124621,56.83%,33.37%
0,第12案,臺中市西屯區,62843,39525,102368,4617,106985,183814,58.2%,34.19%
0,第12案,臺中市南屯區,48668,29856,78524,3659,82183,135448,60.67%,35.93%
0,第12案,臺中市北屯區,77474,47717,125191,5818,131009,227720,57.53%,34.02%
0,第12案,臺中市豐原區,47705,30372,78077,4368,82445,136658,60.33%,34.91%
0,第12案,臺中市東勢區,15459,8291,23750,1700,25450,43181,58.94%,35.8%
0,第12案,臺中市大甲區,21418,13192,34610,2050,36660,63069,58.13%,33.96%
0,第12案,臺中市清水區,23845,15541,39386,2684,42070,71528,58.82%,33.34%
0,第12案,臺中市沙鹿區,24395,15729,40124,2327,42451,74207,57.21%,32.87%
0,第12案,臺中市梧棲區,14659,10642,25301,1655,26956,47040,57.3%,31.16%
0,第12案,臺中市后里區,14278,10266,24544,1693,26237,44962,58.35%,31.76%
0,第12案,臺中市神岡區,18494,12285,30779,1839,32618,54565,59.78%,33.89%
0,第12案,臺中市潭子區,30585,18753,49338,2484,51822,89487,57.91%,34.18%
0,第12案,臺中市大雅區,25855,16532,42387,2133,44520,77189,57.68%,33.5%
0,第12案,臺中市新社區,6763,3969,10732,668,11400,20860,54.65%,32.42%
0,第12案,臺中市石岡區,4303,2820,7123,535,7658,12880,59.46%,33.41%
0,第12案,臺中市外埔區,9162,5824,14986,939,15925,27059,58.85%,33.86%
0,第12案,臺中市大安區,5373,3626,8999,770,9769,16520,59.13%,32.52%
0,第12案,臺中市烏日區,20786,13436,34222,2079,36301,61705,58.83%,33.69%
0,第12案,臺中市大肚區,15756,10368,26124,1642,27766,47457,58.51%,33.2%
0,第12案,臺中市龍井區,20803,13219,34022,2017,36039,63584,56.68%,32.72%
0,第12案,臺中市霧峰區,19150,12175,31325,2203,33528,55225,60.71%,34.68%
0,第12案,臺中市太平區,50405,31955,82360,4450,86810,157926,54.97%,31.92%
0,第12案,臺中市大里區,56856,35523,92379,4759,97138,171769,56.55%,33.1%
0,第12案,臺中市和平區,3507,2116,5623,334,5957,9498,62.72%,36.92%
0,第12案,臺南市,494543,297390,791933,40579,832512,1594821,52.2%,31.01%
0,第12案,臺南市新營區,19145,12148,31293,1479,32772,64949,50.46%,29.48%
0,第12案,臺南市鹽水區,6222,3916,10138,690,10828,22121,48.95%,28.13%
0,第12案,臺南市白河區,6314,4007,10321,787,11108,24894,44.62%,25.36%
0,第12案,臺南市柳營區,5488,3282,8770,728,9498,18804,50.51%,29.19%
0,第12案,臺南市後壁區,5708,3399,9107,809,9916,20841,47.58%,27.39%
0,第12案,臺南市東山區,4205,2542,6747,551,7298,18471,39.51%,22.77%
0,第12案,臺南市麻豆區,10865,7111,17976,1072,19048,37963,50.18%,28.62%
0,第12案,臺南市下營區,5843,3463,9306,801,10107,20947,48.25%,27.89%
0,第12案,臺南市六甲區,4985,3615,8600,810,9410,19144,49.15%,26.04%
0,第12案,臺南市官田區,5317,3399,8716,619,9335,18675,49.99%,28.47%
0,第12案,臺南市大內區,2472,1449,3921,353,4274,8654,49.39%,28.56%
0,第12案,臺南市佳里區,15891,9346,25237,1497,26734,50407,53.04%,31.53%
0,第12案,臺南市學甲區,6362,3995,10357,565,10922,22567,48.4%,28.19%
0,第12案,臺南市西港區,5967,3791,9758,590,10348,21564,47.99%,27.67%
0,第12案,臺南市七股區,6034,3102,9136,529,9665,19950,48.45%,30.25%
0,第12案,臺南市將軍區,5090,2608,7698,715,8413,17754,47.39%,28.67%
0,第12案,臺南市北門區,2592,1437,4029,229,4258,9925,42.9%,26.12%
0,第12案,臺南市新化區,11884,7090,18974,1304,20278,37296,54.37%,31.86%
0,第12案,臺南市善化區,12284,7483,19767,1089,20856,39950,52.21%,30.75%
0,第12案,臺南市新市區,9683,6045,15728,761,16489,30386,54.27%,31.87%
0,第12案,臺南市安定區,8558,4965,13523,769,14292,26104,54.75%,32.78%
0,第12案,臺南市山上區,1677,1053,2730,217,2947,6511,45.26%,25.76%
0,第12案,臺南市玉井區,3583,2062,5645,516,6161,12357,49.86%,29%
0,第12案,臺南市楠西區,2258,1348,3606,313,3919,8528,45.95%,26.48%
0,第12案,臺南市南化區,2076,1360,3436,311,3747,7786,48.12%,26.66%
0,第12案,臺南市左鎮區,1294,651,1945,128,2073,4418,46.92%,29.29%
0,第12案,臺南市仁德區,21284,12041,33325,1669,34994,64632,54.14%,32.93%
0,第12案,臺南市歸仁區,18463,11144,29607,1391,30998,57387,54.02%,32.17%
0,第12案,臺南市關廟區,9556,5839,15395,908,16303,29913,54.5%,31.95%
0,第12案,臺南市龍崎區,1106,639,1745,116,1861,3713,50.12%,29.79%
0,第12案,臺南市永康區,61149,37817,98966,3575,102541,195001,52.58%,31.36%
0,第12案,臺南市東區,51215,30051,81266,3271,84537,153359,55.12%,33.4%
0,第12案,臺南市南區,34717,19769,54486,2355,56841,108650,52.32%,31.95%
0,第12案,臺南市北區,36584,21480,58064,2423,60487,110906,54.54%,32.99%
0,第12案,臺南市安南區,49901,30383,80284,4050,84334,159654,52.82%,31.26%
0,第12案,臺南市安平區,17056,10422,27478,906,28384,55379,51.25%,30.8%
0,第12案,臺南市中西區,21715,13138,34853,1683,36536,65261,55.98%,33.27%
0,第12案,高雄市,857170,491490,1348660,58799,1407459,2353342,59.81%,36.42%
0,第12案,高雄市鹽埕區,8007,4481,12488,430,12918,21617,59.76%,37.04%
0,第12案,高雄市鼓山區,42789,24371,67160,2404,69564,114979,60.5%,37.21%
0,第12案,高雄市左營區,62982,33114,96096,3192,99288,161367,61.53%,39.03%
0,第12案,高雄市楠梓區,55883,31845,87728,3809,91537,153132,59.78%,36.49%
0,第12案,高雄市三民區,105825,62821,168646,6010,174656,289519,60.33%,36.55%
0,第12案,高雄市新興區,16846,9906,26752,1008,27760,44355,62.59%,37.98%
0,第12案,高雄市前金區,8879,5187,14066,568,14634,23928,61.16%,37.11%
0,第12案,高雄市苓雅區,56526,31867,88393,3280,91673,146786,62.45%,38.51%
0,第12案,高雄市前鎮區,58902,33299,92201,4172,96373,161797,59.56%,36.4%
0,第12案,高雄市旗津區,8235,4564,12799,698,13497,24860,54.29%,33.13%
0,第12案,高雄市小港區,47424,28577,76001,3188,79189,132733,59.66%,35.73%
0,第12案,高雄市鳳山區,112232,62692,174924,6965,181889,300510,60.53%,37.35%
0,第12案,高雄市林園區,19699,12191,31890,1675,33565,59129,56.77%,33.32%
0,第12案,高雄市大寮區,34853,19237,54090,2508,56598,97309,58.16%,35.82%
0,第12案,高雄市大樹區,12360,7416,19776,1194,20970,36772,57.03%,33.61%
0,第12案,高雄市大社區,10157,6617,16774,811,17585,30046,58.53%,33.8%
0,第12案,高雄市仁武區,26855,15402,42257,1566,43823,73611,59.53%,36.48%
0,第12案,高雄市鳥松區,14437,8605,23042,1027,24069,39191,61.41%,36.84%
0,第12案,高雄市岡山區,31396,17088,48484,2081,50565,81244,62.24%,38.64%
0,第12案,高雄市橋頭區,12605,6914,19519,1173,20692,32565,63.54%,38.71%
0,第12案,高雄市燕巢區,8895,5268,14163,924,15087,26012,58%,34.2%
0,第12案,高雄市田寮區,1881,1163,3044,265,3309,6671,49.6%,28.2%
0,第12案,高雄市阿蓮區,7823,5018,12841,656,13497,24534,55.01%,31.89%
0,第12案,高雄市路竹區,15241,9468,24709,1503,26212,43850,59.78%,34.76%
0,第12案,高雄市湖內區,8678,5207,13885,732,14617,25729,56.81%,33.73%
0,第12案,高雄市茄萣區,8596,4999,13595,832,14427,26212,55.04%,32.79%
0,第12案,高雄市永安區,4384,2848,7232,408,7640,12001,63.66%,36.53%
0,第12案,高雄市彌陀區,6341,3444,9785,556,10341,16487,62.72%,38.46%
0,第12案,高雄市梓官區,11724,6183,17907,843,18750,31025,60.44%,37.79%
0,第12案,高雄市旗山區,10513,6610,17123,1209,18332,31996,57.29%,32.86%
0,第12案,高雄市美濃區,11579,6583,18162,1388,19550,35311,55.37%,32.79%
0,第12案,高雄市六龜區,3037,1953,4990,511,5501,11501,47.83%,26.41%
0,第12案,高雄市甲仙區,1563,957,2520,207,2727,5417,50.34%,28.85%
0,第12案,高雄市杉林區,2899,1789,4688,364,5052,10607,47.63%,27.33%
0,第12案,高雄市內門區,3884,2209,6093,452,6545,13002,50.34%,29.87%
0,第12案,高雄市茂林區,701,376,1077,46,1123,1615,69.54%,43.41%
0,第12案,高雄市桃源區,1448,715,2163,62,2225,3498,63.61%,41.4%
0,第12案,高雄市那瑪夏區,1091,506,1597,82,1679,2424,69.27%,45.01%
0,第12案,新竹縣,150580,92309,242889,10969,253858,445051,57.04%,33.83%
0,第12案,新竹縣竹北市,47451,29863,77314,2796,80110,137129,58.42%,34.6%
0,第12案,新竹縣竹東鎮,25690,15323,41013,1817,42830,78794,54.36%,32.6%
0,第12案,新竹縣新埔鎮,9575,5965,15540,831,16371,28894,56.66%,33.14%
0,第12案,新竹縣關西鎮,8351,4999,13350,783,14133,24712,57.19%,33.79%
0,第12案,新竹縣湖口鄉,21141,13123,34264,1569,35833,63511,56.42%,33.29%
0,第12案,新竹縣新豐鄉,15412,9190,24602,1075,25677,45790,56.08%,33.66%
0,第12案,新竹縣芎林鄉,6128,3570,9698,545,10243,17293,59.23%,35.44%
0,第12案,新竹縣橫山鄉,3721,2562,6283,459,6742,11346,59.42%,32.8%
0,第12案,新竹縣北埔鄉,2705,1710,4415,247,4662,8180,56.99%,33.07%
0,第12案,新竹縣寶山鄉,4360,2952,7312,373,7685,12973,59.24%,33.61%
0,第12案,新竹縣峨眉鄉,1841,1018,2859,215,3074,5068,60.66%,36.33%
0,第12案,新竹縣尖石鄉,2848,1278,4126,169,4295,7364,58.32%,38.67%
0,第12案,新竹縣五峰鄉,1357,756,2113,90,2203,3997,55.12%,33.95%
0,第12案,苗栗縣,153026,95793,248819,14539,263358,461580,57.06%,33.15%
0,第12案,苗栗縣苗栗市,25845,15204,41049,1875,42924,74249,57.81%,34.81%
0,第12案,苗栗縣苑裡鎮,12787,8254,21041,1412,22453,38890,57.73%,32.88%
0,第12案,苗栗縣通霄鎮,9439,5897,15336,979,16315,29709,54.92%,31.77%
0,第12案,苗栗縣竹南鎮,22781,14039,36820,1791,38611,68528,56.34%,33.24%
0,第12案,苗栗縣頭份市,28607,16747,45354,2239,47593,83617,56.92%,34.21%
0,第12案,苗栗縣後龍鎮,9377,6583,15960,1180,17140,30948,55.38%,30.3%
0,第12案,苗栗縣卓蘭鎮,4969,3120,8089,602,8691,14772,58.83%,33.64%
0,第12案,苗栗縣大湖鄉,3818,2459,6277,492,6769,12653,53.5%,30.17%
0,第12案,苗栗縣公館鄉,9209,6429,15638,1092,16730,28318,59.08%,32.52%
0,第12案,苗栗縣銅鑼鄉,4785,3303,8088,556,8644,15424,56.04%,31.02%
0,第12案,苗栗縣南庄鄉,2369,1691,4060,283,4343,8784,49.44%,26.97%
0,第12案,苗栗縣頭屋鄉,3572,2202,5774,346,6120,9390,65.18%,38.04%
0,第12案,苗栗縣三義鄉,4765,2951,7716,437,8153,13889,58.7%,34.31%
0,第12案,苗栗縣西湖鄉,1975,1337,3312,223,3535,6382,55.39%,30.95%
0,第12案,苗栗縣造橋鄉,3616,2359,5975,448,6423,11027,58.25%,32.79%
0,第12案,苗栗縣三灣鄉,1914,1269,3183,227,3410,5852,58.27%,32.71%
0,第12案,苗栗縣獅潭鄉,1166,700,1866,177,2043,3968,51.49%,29.39%
0,第12案,苗栗縣泰安鄉,2032,1249,3281,180,3461,5180,66.81%,39.23%
0,第12案,彰化縣,356924,224371,581295,35062,616357,1066994,57.77%,33.45%
0,第12案,彰化縣彰化市,68788,41730,110518,5319,115837,190995,60.65%,36.02%
0,第12案,彰化縣鹿港鎮,23865,15045,38910,2357,41267,70505,58.53%,33.85%
0,第12案,彰化縣和美鎮,24610,16291,40901,2138,43039,75286,57.17%,32.69%
0,第12案,彰化縣線西鄉,4751,3117,7868,566,8434,14065,59.96%,33.78%
0,第12案,彰化縣伸港鄉,9720,6433,16153,1105,17258,30407,56.76%,31.97%
0,第12案,彰化縣福興鄉,12923,7536,20459,1253,21712,39745,54.63%,32.51%
0,第12案,彰化縣秀水鄉,11216,7005,18221,1120,19341,32394,59.71%,34.62%
0,第12案,彰化縣花壇鄉,14186,7908,22094,1169,23263,38924,59.77%,36.45%
0,第12案,彰化縣芬園鄉,6526,4148,10674,743,11417,20408,55.94%,31.98%
0,第12案,彰化縣員林市,33660,21760,55420,2842,58262,102028,57.1%,32.99%
0,第12案,彰化縣溪湖鎮,15354,9656,25010,1558,26568,45147,58.85%,34.01%
0,第12案,彰化縣田中鎮,12217,7289,19506,1162,20668,35391,58.4%,34.52%
0,第12案,彰化縣大村鄉,10702,6852,17554,1069,18623,31492,59.14%,33.98%
0,第12案,彰化縣埔鹽鄉,9874,6020,15894,1024,16918,28026,60.37%,35.23%
0,第12案,彰化縣埔心鄉,10317,6885,17202,1169,18371,29642,61.98%,34.81%
0,第12案,彰化縣永靖鄉,10584,7076,17660,1094,18754,31239,60.03%,33.88%
0,第12案,彰化縣社頭鄉,11701,8292,19993,1153,21146,36306,58.24%,32.23%
0,第12案,彰化縣二水鄉,4983,2611,7594,547,8141,13339,61.03%,37.36%
0,第12案,彰化縣北斗鎮,9465,5748,15213,968,16181,27593,58.64%,34.3%
0,第12案,彰化縣二林鎮,13211,8115,21326,1492,22818,42976,53.09%,30.74%
0,第12案,彰化縣田尾鄉,7969,4930,12899,879,13778,23179,59.44%,34.38%
0,第12案,彰化縣埤頭鄉,7832,5029,12861,1146,14007,25677,54.55%,30.5%
0,第12案,彰化縣芳苑鄉,8085,5166,13251,1238,14489,29291,49.47%,27.6%
0,第12案,彰化縣大城鄉,3240,2026,5266,488,5754,14713,39.11%,22.02%
0,第12案,彰化縣竹塘鄉,3755,2717,6472,558,7030,12821,54.83%,29.29%
0,第12案,彰化縣溪州鄉,7390,4986,12376,905,13281,25405,52.28%,29.09%
0,第12案,南投縣,143356,91565,234921,14026,248947,427089,58.29%,33.57%
0,第12案,南投縣南投市,30688,18233,48921,2370,51291,84328,60.82%,36.39%
0,第12案,南投縣埔里鎮,22909,14653,37562,2218,39780,68763,57.85%,33.32%
0,第12案,南投縣草屯鎮,27781,18359,46140,2277,48417,82922,58.39%,33.5%
0,第12案,南投縣竹山鎮,14445,10060,24505,1530,26035,47034,55.35%,30.71%
0,第12案,南投縣集集鎮,2990,2213,5203,387,5590,9611,58.16%,31.11%
0,第12案,南投縣名間鄉,11518,7257,18775,1354,20129,33408,60.25%,34.48%
0,第12案,南投縣鹿谷鄉,4657,3348,8005,616,8621,15941,54.08%,29.21%
0,第12案,南投縣中寮鄉,4197,2902,7099,559,7658,13181,58.1%,31.84%
0,第12案,南投縣魚池鄉,4019,3031,7050,600,7650,13958,54.81%,28.79%
0,第12案,南投縣國姓鄉,5242,3437,8679,657,9336,16597,56.25%,31.58%
0,第12案,南投縣水里鄉,4880,3232,8112,557,8669,15458,56.08%,31.57%
0,第12案,南投縣信義鄉,5655,2337,7992,504,8496,13299,63.88%,42.52%
0,第12案,南投縣仁愛鄉,4375,2503,6878,397,7275,12589,57.79%,34.75%
0,第12案,雲林縣,170393,114101,284494,20533,305027,584480,52.19%,29.15%
0,第12案,雲林縣斗六市,29976,19543,49519,2309,51828,89761,57.74%,33.4%
0,第12案,雲林縣斗南鎮,12689,8180,20869,1151,22020,38138,57.74%,33.27%
0,第12案,雲林縣虎尾鎮,17512,12095,29607,1658,31265,58167,53.75%,30.11%
0,第12案,雲林縣西螺鎮,11288,7807,19095,1400,20495,38142,53.73%,29.59%
0,第12案,雲林縣土庫鎮,7060,4803,11863,1003,12866,24412,52.7%,28.92%
0,第12案,雲林縣北港鎮,10470,6854,17324,1331,18655,33958,54.94%,30.83%
0,第12案,雲林縣古坑鄉,8316,5364,13680,1001,14681,27477,53.43%,30.27%
0,第12案,雲林縣大埤鄉,4704,3339,8043,570,8613,16509,52.17%,28.49%
0,第12案,雲林縣莿桐鄉,7420,5098,12518,1094,13612,24570,55.4%,30.2%
0,第12案,雲林縣林內鄉,4885,3241,8126,715,8841,15551,56.85%,31.41%
0,第12案,雲林縣二崙鄉,6035,4230,10265,995,11260,23367,48.19%,25.83%
0,第12案,雲林縣崙背鄉,5759,3820,9579,797,10376,21050,49.29%,27.36%
0,第12案,雲林縣麥寮鄉,10179,6888,17067,1232,18299,37119,49.3%,27.42%
0,第12案,雲林縣東勢鄉,3613,2464,6077,553,6630,13239,50.08%,27.29%
0,第12案,雲林縣褒忠鄉,3162,2292,5454,428,5882,11381,51.68%,27.78%
0,第12案,雲林縣臺西鄉,5471,3451,8922,809,9731,21125,46.06%,25.9%
0,第12案,雲林縣元長鄉,5559,3683,9242,736,9978,22830,43.71%,24.35%
0,第12案,雲林縣四湖鄉,4509,3123,7632,766,8398,20983,40.02%,21.49%
0,第12案,雲林縣口湖鄉,6409,4123,10532,1122,11654,24193,48.17%,26.49%
0,第12案,雲林縣水林鄉,5377,3703,9080,863,9943,22508,44.18%,23.89%
0,第12案,嘉義縣,132636,81825,214461,13955,228416,442775,51.59%,29.96%
0,第12案,嘉義縣太保市,9940,6382,16322,830,17152,31568,54.33%,31.49%
0,第12案,嘉義縣朴子市,10800,6642,17442,1017,18459,35191,52.45%,30.69%
0,第12案,嘉義縣布袋鎮,6938,4035,10973,850,11823,23965,49.33%,28.95%
0,第12案,嘉義縣大林鎮,8075,5293,13368,815,14183,26922,52.68%,29.99%
0,第12案,嘉義縣民雄鄉,19293,11995,31288,1794,33082,61209,54.05%,31.52%
0,第12案,嘉義縣溪口鄉,4086,2363,6449,445,6894,13105,52.61%,31.18%
0,第12案,嘉義縣新港鄉,8563,5310,13873,1096,14969,27342,54.75%,31.32%
0,第12案,嘉義縣六腳鄉,5217,3177,8394,643,9037,20821,43.4%,25.06%
0,第12案,嘉義縣東石鄉,5453,2984,8437,768,9205,21915,42%,24.88%
0,第12案,嘉義縣義竹鄉,4946,2911,7857,681,8538,16647,51.29%,29.71%
0,第12案,嘉義縣鹿草鄉,3713,2360,6073,556,6629,13937,47.56%,26.64%
0,第12案,嘉義縣水上鄉,13744,8519,22263,1312,23575,43857,53.75%,31.34%
0,第12案,嘉義縣中埔鄉,10814,6970,17784,991,18775,39139,47.97%,27.63%
0,第12案,嘉義縣竹崎鄉,9650,5888,15538,926,16464,31228,52.72%,30.9%
0,第12案,嘉義縣梅山鄉,5569,3298,8867,660,9527,17083,55.77%,32.6%
0,第12案,嘉義縣番路鄉,3278,2041,5319,383,5702,10156,56.14%,32.28%
0,第12案,嘉義縣大埔鄉,1280,822,2102,98,2200,3999,55.01%,32.01%
0,第12案,嘉義縣阿里山鄉,1277,835,2112,90,2202,4691,46.94%,27.22%
0,第12案,屏東縣,216753,136224,352977,23852,376829,711720,52.95%,30.45%
0,第12案,屏東縣屏東市,53638,33114,86752,4173,90925,170148,53.44%,31.52%
0,第12案,屏東縣潮州鎮,14538,8696,23234,1257,24491,46444,52.73%,31.3%
0,第12案,屏東縣東港鎮,11765,7877,19642,1502,21144,39495,53.54%,29.79%
0,第12案,屏東縣恆春鎮,6419,4918,11337,776,12113,25661,47.2%,25.01%
0,第12案,屏東縣萬丹鄉,13536,8355,21891,1574,23465,43478,53.97%,31.13%
0,第12案,屏東縣長治鄉,8236,5259,13495,958,14453,26256,55.05%,31.37%
0,第12案,屏東縣麟洛鄉,3544,2001,5545,321,5866,9970,58.84%,35.55%
0,第12案,屏東縣九如鄉,5776,3695,9471,895,10366,19132,54.18%,30.19%
0,第12案,屏東縣里港鄉,6740,4569,11309,985,12294,22128,55.56%,30.46%
0,第12案,屏東縣鹽埔鄉,6444,4323,10767,873,11640,22402,51.96%,28.77%
0,第12案,屏東縣高樹鄉,5804,3989,9793,1003,10796,21697,49.76%,26.75%
0,第12案,屏東縣萬巒鄉,5074,3640,8714,665,9379,17945,52.27%,28.28%
0,第12案,屏東縣內埔鄉,13292,8506,21798,1402,23200,47558,48.78%,27.95%
0,第12案,屏東縣竹田鄉,5021,3157,8178,678,8856,15353,57.68%,32.7%
0,第12案,屏東縣新埤鄉,2559,1660,4219,377,4596,9033,50.88%,28.33%
0,第12案,屏東縣枋寮鄉,6469,4070,10539,982,11521,21394,53.85%,30.24%
0,第12案,屏東縣新園鄉,9147,5827,14974,1277,16251,30706,52.92%,29.79%
0,第12案,屏東縣崁頂鄉,3662,2334,5996,489,6485,12270,52.85%,29.85%
0,第12案,屏東縣林邊鄉,5149,3009,8158,667,8825,15691,56.24%,32.81%
0,第12案,屏東縣南州鄉,2779,1937,4716,408,5124,9479,54.06%,29.32%
0,第12案,屏東縣佳冬鄉,4877,2953,7830,739,8569,17063,50.22%,28.58%
0,第12案,屏東縣琉球鄉,2812,1611,4423,331,4754,10706,44.41%,26.27%
0,第12案,屏東縣車城鄉,1698,1269,2967,242,3209,7595,42.25%,22.36%
0,第12案,屏東縣滿州鄉,1674,1268,2942,114,3056,7206,42.41%,23.23%
0,第12案,屏東縣枋山鄉,1441,899,2340,185,2525,4856,52%,29.67%
0,第12案,屏東縣三地門鄉,2519,1274,3793,197,3990,6373,62.61%,39.53%
0,第12案,屏東縣霧臺鄉,1573,609,2182,80,2262,2950,76.68%,53.32%
0,第12案,屏東縣瑪家鄉,2430,1185,3615,159,3774,5663,66.64%,42.91%
0,第12案,屏東縣泰武鄉,1763,992,2755,140,2895,4344,66.64%,40.58%
0,第12案,屏東縣來義鄉,2423,1131,3554,192,3746,6257,59.87%,38.72%
0,第12案,屏東縣春日鄉,1095,605,1700,48,1748,3923,44.56%,27.91%
0,第12案,屏東縣獅子鄉,1814,748,2562,97,2659,4230,62.86%,42.88%
0,第12案,屏東縣牡丹鄉,1042,744,1786,66,1852,4314,42.93%,24.15%
0,第12案,宜蘭縣,119746,83726,203472,12663,216135,386089,55.98%,31.02%
0,第12案,宜蘭縣宜蘭市,25673,17297,42970,2111,45081,79167,56.94%,32.43%
0,第12案,宜蘭縣羅東鎮,18673,12875,31548,1743,33291,57686,57.71%,32.37%
0,第12案,宜蘭縣蘇澳鎮,10125,7865,17990,1472,19462,34512,56.39%,29.34%
0,第12案,宜蘭縣頭城鎮,7489,5317,12806,1006,13812,25135,54.95%,29.8%
0,第12案,宜蘭縣礁溪鄉,9089,6782,15871,1029,16900,31084,54.37%,29.24%
0,第12案,宜蘭縣壯圍鄉,6976,4687,11663,891,12554,21447,58.53%,32.53%
0,第12案,宜蘭縣員山鄉,8311,5917,14228,1048,15276,28131,54.3%,29.54%
0,第12案,宜蘭縣冬山鄉,13199,9936,23135,1316,24451,45405,53.85%,29.07%
0,第12案,宜蘭縣五結鄉,10228,7412,17640,1126,18766,34892,53.78%,29.31%
0,第12案,宜蘭縣三星鄉,5535,3892,9427,648,10075,19051,52.88%,29.05%
0,第12案,宜蘭縣大同鄉,2548,867,3415,145,3560,4935,72.14%,51.63%
0,第12案,宜蘭縣南澳鄉,1900,879,2779,128,2907,4644,62.6%,40.91%
0,第12案,花蓮縣,86680,53334,140014,8000,148014,278059,53.23%,31.17%
0,第12案,花蓮縣花蓮市,27589,16285,43874,1893,45767,84807,53.97%,32.53%
0,第12案,花蓮縣鳳林鎮,3083,1883,4966,414,5380,9676,55.6%,31.86%
0,第12案,花蓮縣玉里鎮,5927,3385,9312,821,10133,20650,49.07%,28.7%
0,第12案,花蓮縣新城鄉,5272,3498,8770,504,9274,17029,54.46%,30.96%
0,第12案,花蓮縣吉安鄉,22580,14036,36616,1685,38301,72116,53.11%,31.31%
0,第12案,花蓮縣壽豐鄉,4999,3250,8249,625,8874,15847,56%,31.55%
0,第12案,花蓮縣光復鄉,3542,2088,5630,434,6064,11417,53.11%,31.02%
0,第12案,花蓮縣豐濱鄉,1271,774,2045,132,2177,4395,49.53%,28.92%
0,第12案,花蓮縣瑞穗鄉,2976,1826,4802,425,5227,10279,50.85%,28.95%
0,第12案,花蓮縣富里鄉,2126,1656,3782,391,4173,9065,46.03%,23.45%
0,第12案,花蓮縣秀林鄉,3727,2490,6217,348,6565,12562,52.26%,29.67%
0,第12案,花蓮縣萬榮鄉,1857,1096,2953,176,3129,5269,59.39%,35.24%
0,第12案,花蓮縣卓溪鄉,1731,1067,2798,152,2950,4947,59.63%,34.99%
0,第12案,臺東縣,57826,34122,91948,5646,97594,185996,52.47%,31.09%
0,第12案,臺東縣臺東市,28924,16982,45906,2266,48172,87803,54.86%,32.94%
0,第12案,臺東縣成功鎮,3596,2245,5841,480,6321,12426,50.87%,28.94%
0,第12案,臺東縣關山鎮,2116,1392,3508,240,3748,7509,49.91%,28.18%
0,第12案,臺東縣卑南鄉,4552,2778,7330,596,7926,14976,52.92%,30.4%
0,第12案,臺東縣鹿野鄉,1689,1217,2906,232,3138,6936,45.24%,24.35%
0,第12案,臺東縣池上鄉,1704,1294,2998,306,3304,7162,46.13%,23.79%
0,第12案,臺東縣東河鄉,1990,1176,3166,248,3414,7635,44.72%,26.06%
0,第12案,臺東縣長濱鄉,1623,931,2554,262,2816,6484,43.43%,25.03%
0,第12案,臺東縣太麻里鄉,3374,1678,5052,299,5351,9666,55.36%,34.91%
0,第12案,臺東縣大武鄉,1903,682,2585,198,2783,5266,52.85%,36.14%
0,第12案,臺東縣綠島鄉,945,585,1530,62,1592,3579,44.48%,26.4%
0,第12案,臺東縣海端鄉,1002,680,1682,89,1771,3278,54.03%,30.57%
0,第12案,臺東縣延平鄉,1062,548,1610,97,1707,2930,58.26%,36.25%
0,第12案,臺東縣金峰鄉,1285,627,1912,89,2001,3028,66.08%,42.44%
0,第12案,臺東縣達仁鄉,1207,566,1773,102,1875,3137,59.77%,38.48%
0,第12案,臺東縣蘭嶼鄉,854,741,1595,80,1675,4181,40.06%,20.43%
0,第12案,澎湖縣,24658,14157,38815,2388,41203,90405,45.58%,27.28%
0,第12案,澎湖縣馬公市,15859,9152,25011,1337,26348,53655,49.11%,29.56%
0,第12案,澎湖縣湖西鄉,3346,1956,5302,346,5648,12741,44.33%,26.26%
0,第12案,澎湖縣白沙鄉,2284,1171,3455,241,3696,8625,42.85%,26.48%
0,第12案,澎湖縣西嶼鄉,1439,866,2305,260,2565,7382,34.75%,19.49%
0,第12案,澎湖縣望安鄉,1177,616,1793,121,1914,4628,41.36%,25.43%
0,第12案,澎湖縣七美鄉,553,396,949,83,1032,3374,30.59%,16.39%
0,第12案,金門縣,26932,14773,41705,2222,43927,122695,35.8%,21.95%
0,第12案,金門縣金城鎮,8177,4455,12632,612,13244,37815,35.02%,21.62%
0,第12案,金門縣金沙鎮,4266,1966,6232,342,6574,18560,35.42%,22.98%
0,第12案,金門縣金湖鎮,5863,3118,8981,515,9496,25915,36.64%,22.62%
0,第12案,金門縣金寧鄉,5802,3895,9697,496,10193,28162,36.19%,20.6%
0,第12案,金門縣烈嶼鄉,2711,1293,4004,251,4255,11676,36.44%,23.22%
0,第12案,金門縣烏坵鄉,113,46,159,6,165,567,29.1%,19.93%
0,第12案,連江縣,3599,1925,5524,240,5764,11205,51.44%,32.12%
0,第12案,連江縣南竿鄉,2094,1064,3158,125,3283,6461,50.81%,32.41%
0,第12案,連江縣北竿鄉,713,347,1060,51,1111,2125,52.28%,33.55%
0,第12案,連江縣莒光鄉,467,289,756,36,792,1481,53.48%,31.53%
0,第12案,連江縣東引鄉,325,225,550,28,578,1138,50.79%,28.56%
0,第12案,基隆市,96333,62976,159309,7189,166498,320030,52.03%,30.1%
0,第12案,基隆市中正區,12322,8255,20577,1109,21686,45545,47.61%,27.05%
0,第12案,基隆市七堵區,14532,9137,23669,1092,24761,46256,53.53%,31.42%
0,第12案,基隆市暖暖區,10325,6694,17019,640,17659,33225,53.15%,31.08%
0,第12案,基隆市仁愛區,11401,7385,18786,1047,19833,36738,53.98%,31.03%
0,第12案,基隆市中山區,12443,8188,20631,959,21590,41856,51.58%,29.73%
0,第12案,基隆市安樂區,21005,14155,35160,1473,36633,70396,52.04%,29.84%
0,第12案,基隆市信義區,14305,9162,23467,869,24336,46014,52.89%,31.09%
0,第12案,新竹市,116724,75092,191816,8539,200355,351775,56.96%,33.18%
0,第12案,新竹市東區,54827,35588,90415,3640,94055,163757,57.44%,33.48%
0,第12案,新竹市北區,40483,25931,66414,3115,69529,123122,56.47%,32.88%
0,第12案,新竹市香山區,21414,13573,34987,1784,36771,64896,56.66%,33%
0,第12案,嘉義市,73821,44563,118384,4721,123105,221553,55.56%,33.32%
0,第12案,嘉義市東區,33406,20228,53634,2073,55707,100647,55.35%,33.19%
0,第12案,嘉義市西區,40415,24335,64750,2648,67398,120906,55.74%,33.43%
0,第13案,全國,4763086,5774556,10537642,505153,11042795,19757067,55.89%,24.11%
0,第13案,臺北市,549973,701711,1251684,49738,1301422,2228430,58.4%,24.68%
0,第13案,臺北市松山區,40881,56482,97363,3680,101043,169278,59.69%,24.15%
0,第13案,臺北市信義區,45488,61995,107483,4139,111622,190444,58.61%,23.89%
0,第13案,臺北市大安區,58256,83873,142129,4959,147088,252645,58.22%,23.06%
0,第13案,臺北市中山區,50424,57828,108252,4297,112549,195148,57.67%,25.84%
0,第13案,臺北市中正區,31050,41827,72877,2631,75508,128292,58.86%,24.2%
0,第13案,臺北市大同區,31712,29039,60751,2688,63439,107557,58.98%,29.48%
0,第13案,臺北市萬華區,41906,46381,88287,4181,92468,164020,56.38%,25.55%
0,第13案,臺北市文山區,50746,80777,131523,5573,137096,227211,60.34%,22.33%
0,第13案,臺北市南港區,25347,32271,57618,2196,59814,101907,58.69%,24.87%
0,第13案,臺北市內湖區,57038,77667,134705,4713,139418,236824,58.87%,24.08%
0,第13案,臺北市士林區,63841,70300,134141,5829,139970,241854,57.87%,26.4%
0,第13案,臺北市北投區,53284,63271,116555,4852,121407,213250,56.93%,24.99%
0,第13案,新北市,807514,985763,1793277,87193,1880470,3375513,55.71%,23.92%
0,第13案,新北市板橋區,119330,132183,251513,12943,264456,463411,57.07%,25.75%
0,第13案,新北市三重區,89027,87000,176027,9721,185748,329846,56.31%,26.99%
0,第13案,新北市中和區,78167,112782,190949,8680,199629,355978,56.08%,21.96%
0,第13案,新北市永和區,40769,66263,107032,4634,111666,187798,59.46%,21.71%
0,第13案,新北市新莊區,90070,98684,188754,9447,198201,344981,57.45%,26.11%
0,第13案,新北市新店區,53250,91275,144525,5978,150503,264053,57%,20.17%
0,第13案,新北市樹林區,38133,42649,80782,4017,84799,152102,55.75%,25.07%
0,第13案,新北市鶯歌區,17470,19181,36651,1688,38339,71645,53.51%,24.38%
0,第13案,新北市三峽區,21638,26238,47876,2325,50201,94291,53.24%,22.95%
0,第13案,新北市淡水區,31732,43633,75365,3072,78437,147272,53.26%,21.55%
0,第13案,新北市汐止區,37770,50984,88754,3901,92655,173831,53.3%,21.73%
0,第13案,新北市瑞芳區,7444,8779,16223,1049,17272,35036,49.3%,21.25%
0,第13案,新北市土城區,48850,56610,105460,5222,110682,200783,55.13%,24.33%
0,第13案,新北市蘆洲區,42796,42780,85576,4485,90061,167457,53.78%,25.56%
0,第13案,新北市五股區,18149,18856,37005,1981,38986,72443,53.82%,25.05%
0,第13案,新北市泰山區,15601,18739,34340,1473,35813,64252,55.74%,24.28%
0,第13案,新北市林口區,19747,26923,46670,1802,48472,86203,56.23%,22.91%
0,第13案,新北市深坑區,4965,6014,10979,517,11496,20624,55.74%,24.07%
0,第13案,新北市石碇區,1705,1647,3352,203,3555,6861,51.81%,24.85%
0,第13案,新北市坪林區,1546,1354,2900,180,3080,5891,52.28%,26.24%
0,第13案,新北市三芝區,4301,5036,9337,532,9869,20119,49.05%,21.38%
0,第13案,新北市石門區,2352,2829,5181,321,5502,10528,52.26%,22.34%
0,第13案,新北市八里區,7582,9078,16660,897,17557,32970,53.25%,23%
0,第13案,新北市平溪區,1025,955,1980,138,2118,4321,49.02%,23.72%
0,第13案,新北市雙溪區,1751,1942,3693,255,3948,7999,49.36%,21.89%
0,第13案,新北市貢寮區,2671,2216,4887,308,5195,11279,46.06%,23.68%
0,第13案,新北市金山區,4298,4686,8984,694,9678,18978,51%,22.65%
0,第13案,新北市萬里區,4214,4872,9086,610,9696,19297,50.25%,21.84%
0,第13案,新北市烏來區,1161,1575,2736,120,2856,5264,54.26%,22.06%
0,第13案,桃園市,372182,524453,896635,39083,935718,1801823,51.93%,20.66%
0,第13案,桃園市桃園區,76752,100610,177362,6677,184039,359790,51.15%,21.33%
0,第13案,桃園市中壢區,65661,104366,170027,7201,177228,334402,53%,19.64%
0,第13案,桃園市大溪區,17905,21660,39565,2146,41711,78285,53.28%,22.87%
0,第13案,桃園市楊梅區,25154,42561,67715,2889,70604,137917,51.19%,18.24%
0,第13案,桃園市蘆竹區,28046,35267,63313,2857,66170,129252,51.19%,21.7%
0,第13案,桃園市大園區,16658,19025,35683,1665,37348,73900,50.54%,22.54%
0,第13案,桃園市龜山區,28405,34199,62604,2644,65248,131702,49.54%,21.57%
0,第13案,桃園市八德區,33762,46266,80028,3903,83931,165065,50.85%,20.45%
0,第13案,桃園市龍潭區,19021,33219,52240,2425,54665,101574,53.82%,18.73%
0,第13案,桃園市平鎮區,36737,57455,94192,3912,98104,183560,53.45%,20.01%
0,第13案,桃園市新屋區,9811,12325,22136,1140,23276,41461,56.14%,23.66%
0,第13案,桃園市觀音區,12464,14403,26867,1326,28193,55149,51.12%,22.6%
0,第13案,桃園市復興區,1806,3097,4903,298,5201,9766,53.26%,18.49%
0,第13案,臺中市,554566,726864,1281430,60389,1341819,2295642,58.45%,24.16%
0,第13案,臺中市中區,3924,4112,8036,365,8401,14696,57.17%,26.7%
0,第13案,臺中市東區,16941,19589,36530,1760,38290,64291,59.56%,26.35%
0,第13案,臺中市南區,27658,33699,61357,2729,64086,103643,61.83%,26.69%
0,第13案,臺中市西區,24080,30113,54193,2028,56221,95040,59.16%,25.34%
0,第13案,臺中市北區,29447,39060,68507,2757,71264,124621,57.18%,23.63%
0,第13案,臺中市西屯區,42283,60892,103175,4271,107446,183814,58.45%,23%
0,第13案,臺中市南屯區,33372,45708,79080,3333,82413,135448,60.84%,24.64%
0,第13案,臺中市北屯區,52336,74638,126974,4910,131884,227720,57.91%,22.98%
0,第13案,臺中市豐原區,35654,43291,78945,3839,82784,136658,60.58%,26.09%
0,第13案,臺中市東勢區,9348,14659,24007,1511,25518,43181,59.1%,21.65%
0,第13案,臺中市大甲區,15257,19469,34726,1898,36624,63069,58.07%,24.19%
0,第13案,臺中市清水區,17895,22161,40056,2216,42272,71528,59.1%,25.02%
0,第13案,臺中市沙鹿區,17498,23018,40516,2000,42516,74207,57.29%,23.58%
0,第13案,臺中市梧棲區,11670,14094,25764,1306,27070,47040,57.55%,24.81%
0,第13案,臺中市后里區,10863,14165,25028,1385,26413,44962,58.75%,24.16%
0,第13案,臺中市神岡區,14344,16724,31068,1666,32734,54565,59.99%,26.29%
0,第13案,臺中市潭子區,21605,28122,49727,2169,51896,89487,57.99%,24.14%
0,第13案,臺中市大雅區,17763,24830,42593,2100,44693,77189,57.9%,23.01%
0,第13案,臺中市新社區,4811,6058,10869,612,11481,20860,55.04%,23.06%
0,第13案,臺中市石岡區,3080,4148,7228,455,7683,12880,59.65%,23.91%
0,第13案,臺中市外埔區,6256,8799,15055,857,15912,27059,58.8%,23.12%
0,第13案,臺中市大安區,4122,5051,9173,610,9783,16520,59.22%,24.95%
0,第13案,臺中市烏日區,15313,19254,34567,1901,36468,61705,59.1%,24.82%
0,第13案,臺中市大肚區,11483,14998,26481,1402,27883,47457,58.75%,24.2%
0,第13案,臺中市龍井區,14854,19576,34430,1694,36124,63584,56.81%,23.36%
0,第13案,臺中市霧峰區,13869,17722,31591,2013,33604,55225,60.85%,25.11%
0,第13案,臺中市太平區,35443,47614,83057,4008,87065,157926,55.13%,22.44%
0,第13案,臺中市大里區,41337,51702,93039,4281,97320,171769,56.66%,24.07%
0,第13案,臺中市和平區,2060,3598,5658,313,5971,9498,62.87%,21.69%
0,第13案,臺南市,420409,376916,797325,37455,834780,1594821,52.34%,26.36%
0,第13案,臺南市新營區,15671,16160,31831,1133,32964,64949,50.75%,24.13%
0,第13案,臺南市鹽水區,6084,4506,10590,557,11147,22121,50.39%,27.5%
0,第13案,臺南市白河區,6281,4451,10732,636,11368,24894,45.67%,25.23%
0,第13案,臺南市柳營區,4986,3974,8960,619,9579,18804,50.94%,26.52%
0,第13案,臺南市後壁區,5630,3985,9615,666,10281,20841,49.33%,27.01%
0,第13案,臺南市東山區,3823,3010,6833,453,7286,18471,39.45%,20.7%
0,第13案,臺南市麻豆區,11585,7284,18869,784,19653,37963,51.77%,30.52%
0,第13案,臺南市下營區,5732,3964,9696,576,10272,20947,49.04%,27.36%
0,第13案,臺南市六甲區,5182,3886,9068,528,9596,19144,50.13%,27.07%
0,第13案,臺南市官田區,5375,3614,8989,484,9473,18675,50.73%,28.78%
0,第13案,臺南市大內區,2317,1737,4054,259,4313,8654,49.84%,26.77%
0,第13案,臺南市佳里區,14077,11615,25692,1147,26839,50407,53.24%,27.93%
0,第13案,臺南市學甲區,6136,4365,10501,555,11056,22567,48.99%,27.19%
0,第13案,臺南市西港區,5737,4361,10098,523,10621,21564,49.25%,26.6%
0,第13案,臺南市七股區,5398,3748,9146,501,9647,19950,48.36%,27.06%
0,第13案,臺南市將軍區,4851,3218,8069,398,8467,17754,47.69%,27.32%
0,第13案,臺南市北門區,2304,1803,4107,188,4295,9925,43.27%,23.21%
0,第13案,臺南市新化區,9846,9131,18977,1190,20167,37296,54.07%,26.4%
0,第13案,臺南市善化區,10715,8929,19644,1170,20814,39950,52.1%,26.82%
0,第13案,臺南市新市區,8670,7063,15733,757,16490,30386,54.27%,28.53%
0,第13案,臺南市安定區,7400,5895,13295,908,14203,26104,54.41%,28.35%
0,第13案,臺南市山上區,1588,1170,2758,192,2950,6511,45.31%,24.39%
0,第13案,臺南市玉井區,2695,3045,5740,380,6120,12357,49.53%,21.81%
0,第13案,臺南市楠西區,1650,2029,3679,239,3918,8528,45.94%,19.35%
0,第13案,臺南市南化區,1690,1811,3501,233,3734,7786,47.96%,21.71%
0,第13案,臺南市左鎮區,1051,820,1871,163,2034,4418,46.04%,23.79%
0,第13案,臺南市仁德區,16551,16740,33291,1640,34931,64632,54.05%,25.61%
0,第13案,臺南市歸仁區,15705,13920,29625,1309,30934,57387,53.9%,27.37%
0,第13案,臺南市關廟區,8288,7200,15488,781,16269,29913,54.39%,27.71%
0,第13案,臺南市龍崎區,899,854,1753,118,1871,3713,50.39%,24.21%
0,第13案,臺南市永康區,48369,50117,98486,3912,102398,195001,52.51%,24.8%
0,第13案,臺南市東區,39193,42054,81247,3036,84283,153359,54.96%,25.56%
0,第13案,臺南市南區,29421,25046,54467,2497,56964,108650,52.43%,27.08%
0,第13案,臺南市北區,29375,28648,58023,2485,60508,110906,54.56%,26.49%
0,第13案,臺南市安南區,43287,37148,80435,3855,84290,159654,52.8%,27.11%
0,第13案,臺南市安平區,13735,13614,27349,1023,28372,55379,51.23%,24.8%
0,第13案,臺南市中西區,19112,16001,35113,1560,36673,65261,56.19%,29.29%
0,第13案,高雄市,658515,695878,1354393,58506,1412899,2353342,60.04%,27.98%
0,第13案,高雄市鹽埕區,7028,5717,12745,457,13202,21617,61.07%,32.51%
0,第13案,高雄市鼓山區,31453,36145,67598,2321,69919,114979,60.81%,27.36%
0,第13案,高雄市左營區,41066,55024,96090,3319,99409,161367,61.6%,25.45%
0,第13案,高雄市楠梓區,41039,47325,88364,3859,92223,153132,60.22%,26.8%
0,第13案,高雄市三民區,84073,84839,168912,6310,175222,289519,60.52%,29.04%
0,第13案,高雄市新興區,13820,13072,26892,965,27857,44355,62.8%,31.16%
0,第13案,高雄市前金區,7305,7122,14427,499,14926,23928,62.38%,30.53%
0,第13案,高雄市苓雅區,43358,45565,88923,3225,92148,146786,62.78%,29.54%
0,第13案,高雄市前鎮區,45971,46826,92797,4128,96925,161797,59.91%,28.41%
0,第13案,高雄市旗津區,7375,5403,12778,768,13546,24860,54.49%,29.67%
0,第13案,高雄市小港區,37792,38427,76219,3260,79479,132733,59.88%,28.47%
0,第13案,高雄市鳳山區,80679,93732,174411,7435,181846,300510,60.51%,26.85%
0,第13案,高雄市林園區,16857,15245,32102,1695,33797,59129,57.16%,28.51%
0,第13案,高雄市大寮區,27099,26851,53950,2677,56627,97309,58.19%,27.85%
0,第13案,高雄市大樹區,10872,9517,20389,985,21374,36772,58.13%,29.57%
0,第13案,高雄市大社區,8762,7966,16728,829,17557,30046,58.43%,29.16%
0,第13案,高雄市仁武區,21146,21092,42238,1633,43871,73611,59.6%,28.73%
0,第13案,高雄市鳥松區,11883,11317,23200,966,24166,39191,61.66%,30.32%
0,第13案,高雄市岡山區,22483,26291,48774,2034,50808,81244,62.54%,27.67%
0,第13案,高雄市橋頭區,10943,8929,19872,922,20794,32565,63.85%,33.6%
0,第13案,高雄市燕巢區,7213,7164,14377,816,15193,26012,58.41%,27.73%
0,第13案,高雄市田寮區,1838,1344,3182,214,3396,6671,50.91%,27.55%
0,第13案,高雄市阿蓮區,6635,6419,13054,658,13712,24534,55.89%,27.04%
0,第13案,高雄市路竹區,12332,12501,24833,1465,26298,43850,59.97%,28.12%
0,第13案,高雄市湖內區,7333,6741,14074,667,14741,25729,57.29%,28.5%
0,第13案,高雄市茄萣區,7266,6458,13724,775,14499,26212,55.31%,27.72%
0,第13案,高雄市永安區,3574,3744,7318,366,7684,12001,64.03%,29.78%
0,第13案,高雄市彌陀區,4807,4929,9736,627,10363,16487,62.86%,29.16%
0,第13案,高雄市梓官區,9243,8514,17757,874,18631,31025,60.05%,29.79%
0,第13案,高雄市旗山區,9062,8518,17580,922,18502,31996,57.83%,28.32%
0,第13案,高雄市美濃區,7983,10596,18579,1171,19750,35311,55.93%,22.61%
0,第13案,高雄市六龜區,2314,2752,5066,465,5531,11501,48.09%,20.12%
0,第13案,高雄市甲仙區,1133,1390,2523,202,2725,5417,50.3%,20.92%
0,第13案,高雄市杉林區,2294,2488,4782,296,5078,10607,47.87%,21.63%
0,第13案,高雄市內門區,3104,2956,6060,457,6517,13002,50.12%,23.87%
0,第13案,高雄市茂林區,337,738,1075,47,1122,1615,69.47%,20.87%
0,第13案,高雄市桃源區,548,1289,1837,89,1926,3498,55.06%,15.67%
0,第13案,高雄市那瑪夏區,495,932,1427,108,1535,2424,63.33%,20.42%
0,第13案,新竹縣,89171,151859,241030,11356,252386,445051,56.71%,20.04%
0,第13案,新竹縣竹北市,30388,46425,76813,3079,79892,137129,58.26%,22.16%
0,第13案,新竹縣竹東鎮,13976,26778,40754,1936,42690,78794,54.18%,17.74%
0,第13案,新竹縣新埔鎮,5618,9947,15565,787,16352,28894,56.59%,19.44%
0,第13案,新竹縣關西鎮,4766,8586,13352,735,14087,24712,57%,19.29%
0,第13案,新竹縣湖口鄉,12177,22044,34221,1607,35828,63511,56.41%,19.17%
0,第13案,新竹縣新豐鄉,9188,15404,24592,1173,25765,45790,56.27%,20.07%
0,第13案,新竹縣芎林鄉,3394,6271,9665,538,10203,17293,59%,19.63%
0,第13案,新竹縣橫山鄉,2181,4120,6301,427,6728,11346,59.3%,19.22%
0,第13案,新竹縣北埔鄉,1630,2800,4430,241,4671,8180,57.1%,19.93%
0,第13案,新竹縣寶山鄉,2789,4489,7278,371,7649,12973,58.96%,21.5%
0,第13案,新竹縣峨眉鄉,1108,1764,2872,207,3079,5068,60.75%,21.86%
0,第13案,新竹縣尖石鄉,1322,2023,3345,171,3516,7364,47.75%,17.95%
0,第13案,新竹縣五峰鄉,634,1208,1842,84,1926,3997,48.19%,15.86%
0,第13案,苗栗縣,97041,152791,249832,13709,263541,461580,57.1%,21.02%
0,第13案,苗栗縣苗栗市,13675,27546,41221,1839,43060,74249,57.99%,18.42%
0,第13案,苗栗縣苑裡鎮,10084,11096,21180,1352,22532,38890,57.94%,25.93%
0,第13案,苗栗縣通霄鎮,6886,8240,15126,1096,16222,29709,54.6%,23.18%
0,第13案,苗栗縣竹南鎮,15174,21684,36858,1759,38617,68528,56.35%,22.14%
0,第13案,苗栗縣頭份市,16346,29011,45357,2129,47486,83617,56.79%,19.55%
0,第13案,苗栗縣後龍鎮,7316,8765,16081,1096,17177,30948,55.5%,23.64%
0,第13案,苗栗縣卓蘭鎮,3658,4765,8423,383,8806,14772,59.61%,24.76%
0,第13案,苗栗縣大湖鄉,2284,4100,6384,402,6786,12653,53.63%,18.05%
0,第13案,苗栗縣公館鄉,5861,9817,15678,994,16672,28318,58.87%,20.7%
0,第13案,苗栗縣銅鑼鄉,2919,5279,8198,467,8665,15424,56.18%,18.93%
0,第13案,苗栗縣南庄鄉,1507,2539,4046,305,4351,8784,49.53%,17.16%
0,第13案,苗栗縣頭屋鄉,2284,3557,5841,288,6129,9390,65.27%,24.32%
0,第13案,苗栗縣三義鄉,2653,5168,7821,354,8175,13889,58.86%,19.1%
0,第13案,苗栗縣西湖鄉,1213,2121,3334,218,3552,6382,55.66%,19.01%
0,第13案,苗栗縣造橋鄉,2281,3679,5960,467,6427,11027,58.28%,20.69%
0,第13案,苗栗縣三灣鄉,1147,2026,3173,220,3393,5852,57.98%,19.6%
0,第13案,苗栗縣獅潭鄉,675,1240,1915,138,2053,3968,51.74%,17.01%
0,第13案,苗栗縣泰安鄉,1078,2158,3236,202,3438,5180,66.37%,20.81%
0,第13案,彰化縣,263529,320975,584504,32937,617441,1066994,57.87%,24.7%
0,第13案,彰化縣彰化市,49902,60848,110750,5319,116069,190995,60.77%,26.13%
0,第13案,彰化縣鹿港鎮,18762,20351,39113,2215,41328,70505,58.62%,26.61%
0,第13案,彰化縣和美鎮,17982,23021,41003,2066,43069,75286,57.21%,23.88%
0,第13案,彰化縣線西鄉,3468,4493,7961,497,8458,14065,60.14%,24.66%
0,第13案,彰化縣伸港鄉,7149,9123,16272,1026,17298,30407,56.89%,23.51%
0,第13案,彰化縣福興鄉,10101,10335,20436,1342,21778,39745,54.79%,25.41%
0,第13案,彰化縣秀水鄉,8386,10036,18422,965,19387,32394,59.85%,25.89%
0,第13案,彰化縣花壇鄉,9653,12116,21769,1418,23187,38924,59.57%,24.8%
0,第13案,彰化縣芬園鄉,4761,5964,10725,775,11500,20408,56.35%,23.33%
0,第13案,彰化縣員林市,24024,31703,55727,2545,58272,102028,57.11%,23.55%
0,第13案,彰化縣溪湖鎮,10763,14344,25107,1310,26417,45147,58.51%,23.84%
0,第13案,彰化縣田中鎮,8539,10801,19340,1180,20520,35391,57.98%,24.13%
0,第13案,彰化縣大村鄉,7869,9844,17713,978,18691,31492,59.35%,24.99%
0,第13案,彰化縣埔鹽鄉,6447,9403,15850,1014,16864,28026,60.17%,23%
0,第13案,彰化縣埔心鄉,7892,9368,17260,1150,18410,29642,62.11%,26.62%
0,第13案,彰化縣永靖鄉,8051,9655,17706,967,18673,31239,59.77%,25.77%
0,第13案,彰化縣社頭鄉,9417,10689,20106,1046,21152,36306,58.26%,25.94%
0,第13案,彰化縣二水鄉,3741,3952,7693,480,8173,13339,61.27%,28.05%
0,第13案,彰化縣北斗鎮,6964,8461,15425,870,16295,27593,59.05%,25.24%
0,第13案,彰化縣二林鎮,9219,12239,21458,1387,22845,42976,53.16%,21.45%
0,第13案,彰化縣田尾鄉,5934,7252,13186,703,13889,23179,59.92%,25.6%
0,第13案,彰化縣埤頭鄉,5962,7295,13257,903,14160,25677,55.15%,23.22%
0,第13案,彰化縣芳苑鄉,6731,6926,13657,1081,14738,29291,50.32%,22.98%
0,第13案,彰化縣大城鄉,2427,2958,5385,407,5792,14713,39.37%,16.5%
0,第13案,彰化縣竹塘鄉,3075,3532,6607,465,7072,12821,55.16%,23.98%
0,第13案,彰化縣溪州鄉,6310,6266,12576,828,13404,25405,52.76%,24.84%
0,第13案,南投縣,98462,138563,237025,12379,249404,427089,58.4%,23.05%
0,第13案,南投縣南投市,20281,28852,49133,2236,51369,84328,60.92%,24.05%
0,第13案,南投縣埔里鎮,14608,23503,38111,1896,40007,68763,58.18%,21.24%
0,第13案,南投縣草屯鎮,19594,26875,46469,1925,48394,82922,58.36%,23.63%
0,第13案,南投縣竹山鎮,10910,14061,24971,1442,26413,47034,56.16%,23.2%
0,第13案,南投縣集集鎮,2235,3129,5364,275,5639,9611,58.67%,23.25%
0,第13案,南投縣名間鄉,8870,10276,19146,1131,20277,33408,60.7%,26.55%
0,第13案,南投縣鹿谷鄉,3428,4802,8230,490,8720,15941,54.7%,21.5%
0,第13案,南投縣中寮鄉,3227,3982,7209,469,7678,13181,58.25%,24.48%
0,第13案,南投縣魚池鄉,3070,4159,7229,455,7684,13958,55.05%,21.99%
0,第13案,南投縣國姓鄉,3596,5452,9048,528,9576,16597,57.7%,21.67%
0,第13案,南投縣水里鄉,3390,4848,8238,458,8696,15458,56.26%,21.93%
0,第13案,南投縣信義鄉,2855,4238,7093,704,7797,13299,58.63%,21.47%
0,第13案,南投縣仁愛鄉,2398,4386,6784,370,7154,12589,56.83%,19.05%
0,第13案,雲林縣,139350,150404,289754,17607,307361,584480,52.59%,23.84%
0,第13案,雲林縣斗六市,21383,28507,49890,2164,52054,89761,57.99%,23.82%
0,第13案,雲林縣斗南鎮,9624,11149,20773,1198,21971,38138,57.61%,25.23%
0,第13案,雲林縣虎尾鎮,13438,16721,30159,1428,31587,58167,54.3%,23.1%
0,第13案,雲林縣西螺鎮,9923,9723,19646,1117,20763,38142,54.44%,26.02%
0,第13案,雲林縣土庫鎮,5972,6117,12089,855,12944,24412,53.02%,24.46%
0,第13案,雲林縣北港鎮,8945,8645,17590,1134,18724,33958,55.14%,26.34%
0,第13案,雲林縣古坑鄉,6473,7378,13851,916,14767,27477,53.74%,23.56%
0,第13案,雲林縣大埤鄉,4160,4038,8198,508,8706,16509,52.73%,25.2%
0,第13案,雲林縣莿桐鄉,6611,6226,12837,908,13745,24570,55.94%,26.91%
0,第13案,雲林縣林內鄉,3758,4413,8171,670,8841,15551,56.85%,24.17%
0,第13案,雲林縣二崙鄉,6007,4882,10889,647,11536,23367,49.37%,25.71%
0,第13案,雲林縣崙背鄉,4948,4833,9781,665,10446,21050,49.62%,23.51%
0,第13案,雲林縣麥寮鄉,7504,9568,17072,1258,18330,37119,49.38%,20.22%
0,第13案,雲林縣東勢鄉,3163,3039,6202,459,6661,13239,50.31%,23.89%
0,第13案,雲林縣褒忠鄉,2827,2858,5685,310,5995,11381,52.68%,24.84%
0,第13案,雲林縣臺西鄉,4206,4886,9092,681,9773,21125,46.26%,19.91%
0,第13案,雲林縣元長鄉,4961,4519,9480,676,10156,22830,44.49%,21.73%
0,第13案,雲林縣四湖鄉,4104,3832,7936,574,8510,20983,40.56%,19.56%
0,第13案,雲林縣口湖鄉,5904,4971,10875,824,11699,24193,48.36%,24.4%
0,第13案,雲林縣水林鄉,5439,4099,9538,615,10153,22508,45.11%,24.16%
0,第13案,嘉義縣,110830,103993,214823,13483,228306,442775,51.56%,25.03%
0,第13案,嘉義縣太保市,8074,8157,16231,833,17064,31568,54.05%,25.58%
0,第13案,嘉義縣朴子市,8989,8484,17473,1049,18522,35191,52.63%,25.54%
0,第13案,嘉義縣布袋鎮,5637,5557,11194,756,11950,23965,49.86%,23.52%
0,第13案,嘉義縣大林鎮,6763,6675,13438,784,14222,26922,52.83%,25.12%
0,第13案,嘉義縣民雄鄉,16033,15073,31106,1892,32998,61209,53.91%,26.19%
0,第13案,嘉義縣溪口鄉,3716,2754,6470,430,6900,13105,52.65%,28.36%
0,第13案,嘉義縣新港鄉,8171,6024,14195,892,15087,27342,55.18%,29.88%
0,第13案,嘉義縣六腳鄉,4734,3723,8457,612,9069,20821,43.56%,22.74%
0,第13案,嘉義縣東石鄉,4475,3938,8413,693,9106,21915,41.55%,20.42%
0,第13案,嘉義縣義竹鄉,4412,3735,8147,523,8670,16647,52.08%,26.5%
0,第13案,嘉義縣鹿草鄉,3491,2765,6256,462,6718,13937,48.2%,25.05%
0,第13案,嘉義縣水上鄉,11291,10944,22235,1289,23524,43857,53.64%,25.75%
0,第13案,嘉義縣中埔鄉,8874,8617,17491,1105,18596,39139,47.51%,22.67%
0,第13案,嘉義縣竹崎鄉,7748,7724,15472,976,16448,31228,52.67%,24.81%
0,第13案,嘉義縣梅山鄉,4342,4380,8722,611,9333,17083,54.63%,25.42%
0,第13案,嘉義縣番路鄉,2438,2903,5341,378,5719,10156,56.31%,24.01%
0,第13案,嘉義縣大埔鄉,974,1125,2099,104,2203,3999,55.09%,24.36%
0,第13案,嘉義縣阿里山鄉,668,1415,2083,94,2177,4691,46.41%,14.24%
0,第13案,屏東縣,180402,177106,357508,19822,377330,711720,53.02%,25.35%
0,第13案,屏東縣屏東市,40920,47103,88023,3450,91473,170148,53.76%,24.05%
0,第13案,屏東縣潮州鎮,11749,11734,23483,1123,24606,46444,52.98%,25.3%
0,第13案,屏東縣東港鎮,10734,9353,20087,1208,21295,39495,53.92%,27.18%
0,第13案,屏東縣恆春鎮,5658,5977,11635,631,12266,25661,47.8%,22.05%
0,第13案,屏東縣萬丹鄉,11585,10424,22009,1308,23317,43478,53.63%,26.65%
0,第13案,屏東縣長治鄉,6734,6835,13569,944,14513,26256,55.27%,25.65%
0,第13案,屏東縣麟洛鄉,3089,2687,5776,226,6002,9970,60.2%,30.98%
0,第13案,屏東縣九如鄉,5803,4169,9972,605,10577,19132,55.28%,30.33%
0,第13案,屏東縣里港鄉,6451,5210,11661,646,12307,22128,55.62%,29.15%
0,第13案,屏東縣鹽埔鄉,5568,5464,11032,731,11763,22402,52.51%,24.85%
0,第13案,屏東縣高樹鄉,6107,4502,10609,740,11349,21697,52.31%,28.15%
0,第13案,屏東縣萬巒鄉,5053,3867,8920,621,9541,17945,53.17%,28.16%
0,第13案,屏東縣內埔鄉,11532,10690,22222,1185,23407,47558,49.22%,24.25%
0,第13案,屏東縣竹田鄉,4570,3875,8445,501,8946,15353,58.27%,29.77%
0,第13案,屏東縣新埤鄉,2345,2017,4362,284,4646,9033,51.43%,25.96%
0,第13案,屏東縣枋寮鄉,5601,5322,10923,735,11658,21394,54.49%,26.18%
0,第13案,屏東縣新園鄉,8686,6597,15283,1119,16402,30706,53.42%,28.29%
0,第13案,屏東縣崁頂鄉,3400,2820,6220,359,6579,12270,53.62%,27.71%
0,第13案,屏東縣林邊鄉,4800,3582,8382,503,8885,15691,56.62%,30.59%
0,第13案,屏東縣南州鄉,2691,2109,4800,321,5121,9479,54.02%,28.39%
0,第13案,屏東縣佳冬鄉,4645,3506,8151,530,8681,17063,50.88%,27.22%
0,第13案,屏東縣琉球鄉,2007,2413,4420,336,4756,10706,44.42%,18.75%
0,第13案,屏東縣車城鄉,1726,1389,3115,178,3293,7595,43.36%,22.73%
0,第13案,屏東縣滿州鄉,1516,1526,3042,127,3169,7206,43.98%,21.04%
0,第13案,屏東縣枋山鄉,1336,1123,2459,132,2591,4856,53.36%,27.51%
0,第13案,屏東縣三地門鄉,1159,2072,3231,244,3475,6373,54.53%,18.19%
0,第13案,屏東縣霧臺鄉,477,1108,1585,98,1683,2950,57.05%,16.17%
0,第13案,屏東縣瑪家鄉,1118,2186,3304,201,3505,5663,61.89%,19.74%
0,第13案,屏東縣泰武鄉,821,1705,2526,243,2769,4344,63.74%,18.9%
0,第13案,屏東縣來義鄉,901,2490,3391,268,3659,6257,58.48%,14.4%
0,第13案,屏東縣春日鄉,438,739,1177,46,1223,3923,31.18%,11.16%
0,第13案,屏東縣獅子鄉,558,1421,1979,109,2088,4230,49.36%,13.19%
0,第13案,屏東縣牡丹鄉,624,1091,1715,70,1785,4314,41.38%,14.46%
0,第13案,宜蘭縣,102924,101242,204166,11719,215885,386089,55.92%,26.66%
0,第13案,宜蘭縣宜蘭市,20491,22551,43042,2110,45152,79167,57.03%,25.88%
0,第13案,宜蘭縣羅東鎮,15860,15867,31727,1586,33313,57686,57.75%,27.49%
0,第13案,宜蘭縣蘇澳鎮,9632,8737,18369,1205,19574,34512,56.72%,27.91%
0,第13案,宜蘭縣頭城鎮,6302,6628,12930,933,13863,25135,55.15%,25.07%
0,第13案,宜蘭縣礁溪鄉,8420,7666,16086,880,16966,31084,54.58%,27.09%
0,第13案,宜蘭縣壯圍鄉,6448,5286,11734,804,12538,21447,58.46%,30.06%
0,第13案,宜蘭縣員山鄉,7425,6801,14226,1088,15314,28131,54.44%,26.39%
0,第13案,宜蘭縣冬山鄉,12475,11161,23636,1144,24780,45405,54.58%,27.47%
0,第13案,宜蘭縣五結鄉,9229,8750,17979,944,18923,34892,54.23%,26.45%
0,第13案,宜蘭縣三星鄉,5141,4384,9525,602,10127,19051,53.16%,26.99%
0,第13案,宜蘭縣大同鄉,829,1487,2316,244,2560,4935,51.87%,16.8%
0,第13案,宜蘭縣南澳鄉,672,1924,2596,179,2775,4644,59.75%,14.47%
0,第13案,花蓮縣,49349,88466,137815,8716,146531,278059,52.7%,17.75%
0,第13案,花蓮縣花蓮市,15490,28503,43993,1933,45926,84807,54.15%,18.27%
0,第13案,花蓮縣鳳林鎮,1806,3192,4998,387,5385,9676,55.65%,18.66%
0,第13案,花蓮縣玉里鎮,3227,5640,8867,960,9827,20650,47.59%,15.63%
0,第13案,花蓮縣新城鄉,3203,5586,8789,498,9287,17029,54.54%,18.81%
0,第13案,花蓮縣吉安鄉,12483,23812,36295,1811,38106,72116,52.84%,17.31%
0,第13案,花蓮縣壽豐鄉,3200,4894,8094,618,8712,15847,54.98%,20.19%
0,第13案,花蓮縣光復鄉,1921,3428,5349,556,5905,11417,51.72%,16.83%
0,第13案,花蓮縣豐濱鄉,678,1046,1724,266,1990,4395,45.28%,15.43%
0,第13案,花蓮縣瑞穗鄉,1706,3005,4711,407,5118,10279,49.79%,16.6%
0,第13案,花蓮縣富里鄉,1492,2331,3823,373,4196,9065,46.29%,16.46%
0,第13案,花蓮縣秀林鄉,2351,3600,5951,389,6340,12562,50.47%,18.72%
0,第13案,花蓮縣萬榮鄉,1000,1684,2684,251,2935,5269,55.7%,18.98%
0,第13案,花蓮縣卓溪鄉,792,1745,2537,267,2804,4947,56.68%,16.01%
0,第13案,臺東縣,33959,55792,89751,6451,96202,185996,51.72%,18.26%
0,第13案,臺東縣臺東市,16986,28706,45692,2472,48164,87803,54.85%,19.35%
0,第13案,臺東縣成功鎮,1958,3637,5595,601,6196,12426,49.86%,15.76%
0,第13案,臺東縣關山鎮,1337,2230,3567,191,3758,7509,50.05%,17.81%
0,第13案,臺東縣卑南鄉,3064,4252,7316,610,7926,14976,52.92%,20.46%
0,第13案,臺東縣鹿野鄉,1313,1643,2956,206,3162,6936,45.59%,18.93%
0,第13案,臺東縣池上鄉,1293,1841,3134,221,3355,7162,46.84%,18.05%
0,第13案,臺東縣東河鄉,1212,1835,3047,299,3346,7635,43.82%,15.87%
0,第13案,臺東縣長濱鄉,927,1458,2385,358,2743,6484,42.3%,14.3%
0,第13案,臺東縣太麻里鄉,1819,2565,4384,385,4769,9666,49.34%,18.82%
0,第13案,臺東縣大武鄉,915,1442,2357,348,2705,5266,51.37%,17.38%
0,第13案,臺東縣綠島鄉,520,1005,1525,62,1587,3579,44.34%,14.53%
0,第13案,臺東縣海端鄉,523,1084,1607,144,1751,3278,53.42%,15.95%
0,第13案,臺東縣延平鄉,462,977,1439,134,1573,2930,53.69%,15.77%
0,第13案,臺東縣金峰鄉,473,1125,1598,156,1754,3028,57.93%,15.62%
0,第13案,臺東縣達仁鄉,512,1133,1645,163,1808,3137,57.63%,16.32%
0,第13案,臺東縣蘭嶼鄉,645,859,1504,101,1605,4181,38.39%,15.43%
0,第13案,澎湖縣,16396,23036,39432,2016,41448,90405,45.85%,18.14%
0,第13案,澎湖縣馬公市,9944,15334,25278,1141,26419,53655,49.24%,18.53%
0,第13案,澎湖縣湖西鄉,2445,3017,5462,269,5731,12741,44.98%,19.19%
0,第13案,澎湖縣白沙鄉,1526,1997,3523,211,3734,8625,43.29%,17.69%
0,第13案,澎湖縣西嶼鄉,1206,1232,2438,213,2651,7382,35.91%,16.34%
0,第13案,澎湖縣望安鄉,838,934,1772,111,1883,4628,40.69%,18.11%
0,第13案,澎湖縣七美鄉,437,522,959,71,1030,3374,30.53%,12.95%
0,第13案,金門縣,9644,32014,41658,2263,43921,122695,35.8%,7.86%
0,第13案,金門縣金城鎮,2880,9719,12599,642,13241,37815,35.02%,7.62%
0,第13案,金門縣金沙鎮,1336,4889,6225,348,6573,18560,35.41%,7.2%
0,第13案,金門縣金湖鎮,2089,6851,8940,575,9515,25915,36.72%,8.06%
0,第13案,金門縣金寧鄉,2506,7185,9691,483,10174,28162,36.13%,8.9%
0,第13案,金門縣烈嶼鄉,790,3255,4045,207,4252,11676,36.42%,6.77%
0,第13案,金門縣烏坵鄉,43,115,158,8,166,567,29.28%,7.58%
0,第13案,連江縣,1176,4390,5566,190,5756,11205,51.37%,10.5%
0,第13案,連江縣南竿鄉,658,2524,3182,106,3288,6461,50.89%,10.18%
0,第13案,連江縣北竿鄉,215,853,1068,38,1106,2125,52.05%,10.12%
0,第13案,連江縣莒光鄉,181,582,763,25,788,1481,53.21%,12.22%
0,第13案,連江縣東引鄉,122,431,553,21,574,1138,50.44%,10.72%
0,第13案,基隆市,68736,90381,159117,7385,166502,320030,52.03%,21.48%
0,第13案,基隆市中正區,8903,11755,20658,1089,21747,45545,47.75%,19.55%
0,第13案,基隆市七堵區,10557,12865,23422,1218,24640,46256,53.27%,22.82%
0,第13案,基隆市暖暖區,7218,9770,16988,662,17650,33225,53.12%,21.72%
0,第13案,基隆市仁愛區,8790,10057,18847,1071,19918,36738,54.22%,23.93%
0,第13案,基隆市中山區,9114,11334,20448,1018,21466,41856,51.29%,21.77%
0,第13案,基隆市安樂區,14810,20552,35362,1406,36768,70396,52.23%,21.04%
0,第13案,基隆市信義區,9344,14048,23392,921,24313,46014,52.84%,20.31%
0,第13案,新竹市,80567,111788,192355,8062,200417,351775,56.97%,22.9%
0,第13案,新竹市東區,36854,53513,90367,3608,93975,163757,57.39%,22.51%
0,第13案,新竹市北區,28399,38393,66792,2782,69574,123122,56.51%,23.07%
0,第13案,新竹市香山區,15314,19882,35196,1672,36868,64896,56.81%,23.6%
0,第13案,嘉義市,58391,60171,118562,4694,123256,221553,55.63%,26.36%
0,第13案,嘉義市東區,25763,27911,53674,2164,55838,100647,55.48%,25.6%
0,第13案,嘉義市西區,32628,32260,64888,2530,67418,120906,55.76%,26.99%
0,第14案,全國,3382286,6949697,10331983,608484,10940467,19757067,55.37%,17.12%
0,第14案,臺北市,469793,762277,1232070,59045,1291115,2228430,57.94%,21.08%
0,第14案,臺北市松山區,36698,59358,96056,4370,100426,169278,59.33%,21.68%
0,第14案,臺北市信義區,39545,66509,106054,4758,110812,190444,58.19%,20.76%
0,第14案,臺北市大安區,53370,87228,140598,5605,146203,252645,57.87%,21.12%
0,第14案,臺北市中山區,41628,64606,106234,5201,111435,195148,57.1%,21.33%
0,第14案,臺北市中正區,26803,45286,72089,3086,75175,128292,58.6%,20.89%
0,第14案,臺北市大同區,23597,35491,59088,3422,62510,107557,58.12%,21.94%
0,第14案,臺北市萬華區,32071,54169,86240,5330,91570,164020,55.83%,19.55%
0,第14案,臺北市文山區,47668,82459,130127,5924,136051,227211,59.88%,20.98%
0,第14案,臺北市南港區,21854,35073,56927,2530,59457,101907,58.34%,21.45%
0,第14案,臺北市內湖區,52075,81158,133233,5297,138530,236824,58.49%,21.99%
0,第14案,臺北市士林區,50658,80462,131120,7567,138687,241854,57.34%,20.95%
0,第14案,臺北市北投區,43826,70478,114304,5955,120259,213250,56.39%,20.55%
0,第14案,新北市,616312,1148290,1764602,103690,1868292,3375513,55.35%,18.26%
0,第14案,新北市板橋區,88512,158751,247263,15343,262606,463411,56.67%,19.1%
0,第14案,新北市三重區,62307,109279,171586,12940,184526,329846,55.94%,18.89%
0,第14案,新北市中和區,63839,124418,188257,9944,198201,355978,55.68%,17.93%
0,第14案,新北市永和區,36235,69918,106153,4925,111078,187798,59.15%,19.29%
0,第14案,新北市新莊區,66304,118755,185059,11384,196443,344981,56.94%,19.22%
0,第14案,新北市新店區,47379,95746,143125,6697,149822,264053,56.74%,17.94%
0,第14案,新北市樹林區,27613,52060,79673,4595,84268,152102,55.4%,18.15%
0,第14案,新北市鶯歌區,12235,23842,36077,1985,38062,71645,53.13%,17.08%
0,第14案,新北市三峽區,15839,31579,47418,2464,49882,94291,52.9%,16.8%
0,第14案,新北市淡水區,26961,47281,74242,3608,77850,147272,52.86%,18.31%
0,第14案,新北市汐止區,31677,55598,87275,4707,91982,173831,52.91%,18.22%
0,第14案,新北市瑞芳區,4937,10761,15698,1317,17015,35036,48.56%,14.09%
0,第14案,新北市土城區,36847,67566,104413,5912,110325,200783,54.95%,18.35%
0,第14案,新北市蘆洲區,30458,54275,84733,5146,89879,167457,53.67%,18.19%
0,第14案,新北市五股區,12563,24051,36614,2267,38881,72443,53.67%,17.34%
0,第14案,新北市泰山區,11483,22314,33797,1789,35586,64252,55.39%,17.87%
0,第14案,新北市林口區,16387,29678,46065,2208,48273,86203,56%,19.01%
0,第14案,新北市深坑區,3779,6991,10770,587,11357,20624,55.07%,18.32%
0,第14案,新北市石碇區,1015,2155,3170,300,3470,6861,50.58%,14.79%
0,第14案,新北市坪林區,828,1904,2732,293,3025,5891,51.35%,14.06%
0,第14案,新北市三芝區,3073,6026,9099,671,9770,20119,48.56%,15.27%
0,第14案,新北市石門區,1535,3352,4887,570,5457,10528,51.83%,14.58%
0,第14案,新北市八里區,5618,10819,16437,1047,17484,32970,53.03%,17.04%
0,第14案,新北市平溪區,523,1348,1871,207,2078,4321,48.09%,12.1%
0,第14案,新北市雙溪區,1051,2456,3507,376,3883,7999,48.54%,13.14%
0,第14案,新北市貢寮區,1379,3133,4512,455,4967,11279,44.04%,12.23%
0,第14案,新北市金山區,2654,5944,8598,1046,9644,18978,50.82%,13.98%
0,第14案,新北市萬里區,2471,6352,8823,795,9618,19297,49.84%,12.81%
0,第14案,新北市烏來區,810,1938,2748,112,2860,5264,54.33%,15.39%
0,第14案,桃園市,282142,603494,885636,44083,929719,1801823,51.6%,15.66%
0,第14案,桃園市桃園區,60327,114427,174754,7782,182536,359790,50.73%,16.77%
0,第14案,桃園市中壢區,53274,115313,168587,7636,176223,334402,52.7%,15.93%
0,第14案,桃園市大溪區,11844,26711,38555,2818,41373,78285,52.85%,15.13%
0,第14案,桃園市楊梅區,19418,47700,67118,3315,70433,137917,51.07%,14.08%
0,第14案,桃園市蘆竹區,20705,41836,62541,3072,65613,129252,50.76%,16.02%
0,第14案,桃園市大園區,11241,23944,35185,1753,36938,73900,49.98%,15.21%
0,第14案,桃園市龜山區,21039,40715,61754,3114,64868,131702,49.25%,15.97%
0,第14案,桃園市八德區,25238,53665,78903,4498,83401,165065,50.53%,15.29%
0,第14案,桃園市龍潭區,14882,36956,51838,2571,54409,101574,53.57%,14.65%
0,第14案,桃園市平鎮區,29045,64386,93431,4155,97586,183560,53.16%,15.82%
0,第14案,桃園市新屋區,6086,15647,21733,1409,23142,41461,55.82%,14.68%
0,第14案,桃園市觀音區,8076,18134,26210,1669,27879,55149,50.55%,14.64%
0,第14案,桃園市復興區,967,4060,5027,291,5318,9766,54.45%,9.9%
0,第14案,臺中市,395557,866827,1262384,71128,1333512,2295642,58.09%,17.23%
0,第14案,臺中市中區,2451,5329,7780,489,8269,14696,56.27%,16.68%
0,第14案,臺中市東區,11817,24192,36009,2003,38012,64291,59.12%,18.38%
0,第14案,臺中市南區,20611,39862,60473,3253,63726,103643,61.49%,19.89%
0,第14案,臺中市西區,18475,34789,53264,2577,55841,95040,58.76%,19.44%
0,第14案,臺中市北區,22588,44811,67399,3166,70565,124621,56.62%,18.13%
0,第14案,臺中市西屯區,34071,67645,101716,4986,106702,183814,58.05%,18.54%
0,第14案,臺中市南屯區,26220,52042,78262,3769,82031,135448,60.56%,19.36%
0,第14案,臺中市北屯區,40045,85010,125055,5636,130691,227720,57.39%,17.59%
0,第14案,臺中市豐原區,23853,53873,77726,4566,82292,136658,60.22%,17.45%
0,第14案,臺中市東勢區,6038,17546,23584,1865,25449,43181,58.94%,13.98%
0,第14案,臺中市大甲區,10111,23943,34054,2346,36400,63069,57.71%,16.03%
0,第14案,臺中市清水區,12030,27156,39186,2752,41938,71528,58.63%,16.82%
0,第14案,臺中市沙鹿區,12165,27773,39938,2330,42268,74207,56.96%,16.39%
0,第14案,臺中市梧棲區,7603,17622,25225,1685,26910,47040,57.21%,16.16%
0,第14案,臺中市后里區,7155,17267,24422,1819,26241,44962,58.36%,15.91%
0,第14案,臺中市神岡區,8920,21601,30521,2080,32601,54565,59.75%,16.35%
0,第14案,臺中市潭子區,15517,33540,49057,2556,51613,89487,57.68%,17.34%
0,第14案,臺中市大雅區,12308,29879,42187,2229,44416,77189,57.54%,15.95%
0,第14案,臺中市新社區,2779,7819,10598,667,11265,20860,54%,13.32%
0,第14案,臺中市石岡區,1890,5229,7119,531,7650,12880,59.39%,14.67%
0,第14案,臺中市外埔區,3965,10906,14871,999,15870,27059,58.65%,14.65%
0,第14案,臺中市大安區,2478,6446,8924,810,9734,16520,58.92%,15%
0,第14案,臺中市烏日區,10429,23671,34100,2151,36251,61705,58.75%,16.9%
0,第14案,臺中市大肚區,7711,18322,26033,1711,27744,47457,58.46%,16.25%
0,第14案,臺中市龍井區,10845,23194,34039,1946,35985,63584,56.59%,17.06%
0,第14案,臺中市霧峰區,8969,22232,31201,2261,33462,55225,60.59%,16.24%
0,第14案,臺中市太平區,24875,57165,82040,4681,86721,157926,54.91%,15.75%
0,第14案,臺中市大里區,28448,63477,91925,4937,96862,171769,56.39%,16.56%
0,第14案,臺中市和平區,1190,4486,5676,327,6003,9498,63.2%,12.53%
0,第14案,臺南市,257730,515188,772918,47869,820787,1594821,51.47%,16.16%
0,第14案,臺南市新營區,10002,20659,30661,1697,32358,64949,49.82%,15.4%
0,第14案,臺南市鹽水區,3142,6633,9775,858,10633,22121,48.07%,14.2%
0,第14案,臺南市白河區,3182,6671,9853,901,10754,24894,43.2%,12.78%
0,第14案,臺南市柳營區,2607,5834,8441,866,9307,18804,49.49%,13.86%
0,第14案,臺南市後壁區,2733,5938,8671,964,9635,20841,46.23%,13.11%
0,第14案,臺南市東山區,1904,4405,6309,686,6995,18471,37.87%,10.31%
0,第14案,臺南市麻豆區,6054,11606,17660,991,18651,37963,49.13%,15.95%
0,第14案,臺南市下營區,2968,6079,9047,811,9858,20947,47.06%,14.17%
0,第14案,臺南市六甲區,2846,5630,8476,805,9281,19144,48.48%,14.87%
0,第14案,臺南市官田區,3074,5324,8398,692,9090,18675,48.67%,16.46%
0,第14案,臺南市大內區,1076,2658,3734,419,4153,8654,47.99%,12.43%
0,第14案,臺南市佳里區,7962,16801,24763,1644,26407,50407,52.39%,15.8%
0,第14案,臺南市學甲區,3070,6899,9969,739,10708,22567,47.45%,13.6%
0,第14案,臺南市西港區,3094,6473,9567,608,10175,21564,47.19%,14.35%
0,第14案,臺南市七股區,2603,5898,8501,631,9132,19950,45.77%,13.05%
0,第14案,臺南市將軍區,2193,5225,7418,517,7935,17754,44.69%,12.35%
0,第14案,臺南市北門區,1237,2600,3837,258,4095,9925,41.26%,12.46%
0,第14案,臺南市新化區,5988,12714,18702,1443,20145,37296,54.01%,16.06%
0,第14案,臺南市善化區,6753,12468,19221,1254,20475,39950,51.25%,16.9%
0,第14案,臺南市新市區,4981,10371,15352,957,16309,30386,53.67%,16.39%
0,第14案,臺南市安定區,4048,8901,12949,1132,14081,26104,53.94%,15.51%
0,第14案,臺南市山上區,852,1766,2618,255,2873,6511,44.13%,13.09%
0,第14案,臺南市玉井區,1543,4001,5544,469,6013,12357,48.66%,12.49%
0,第14案,臺南市楠西區,892,2621,3513,334,3847,8528,45.11%,10.46%
0,第14案,臺南市南化區,974,2417,3391,327,3718,7786,47.75%,12.51%
0,第14案,臺南市左鎮區,447,1308,1755,231,1986,4418,44.95%,10.12%
0,第14案,臺南市仁德區,10442,22130,32572,1886,34458,64632,53.31%,16.16%
0,第14案,臺南市歸仁區,9985,18947,28932,1603,30535,57387,53.21%,17.4%
0,第14案,臺南市關廟區,4616,10284,14900,1039,15939,29913,53.28%,15.43%
0,第14案,臺南市龍崎區,483,1180,1663,151,1814,3713,48.86%,13.01%
0,第14案,臺南市永康區,32872,63632,96504,4864,101368,195001,51.98%,16.86%
0,第14案,臺南市東區,27901,52576,80477,3521,83998,153359,54.77%,18.19%
0,第14案,臺南市南區,17491,35260,52751,3296,56047,108650,51.58%,16.1%
0,第14案,臺南市北區,19963,37147,57110,2775,59885,110906,54%,18%
0,第14案,臺南市安南區,26267,52189,78456,5141,83597,159654,52.36%,16.45%
0,第14案,臺南市安平區,9422,17626,27048,1183,28231,55379,50.98%,17.01%
0,第14案,臺南市中西區,12063,22317,34380,1921,36301,65261,55.62%,18.48%
0,第14案,高雄市,427186,885698,1312884,74414,1387298,2353342,58.95%,18.15%
0,第14案,高雄市鹽埕區,4601,7454,12055,501,12556,21617,58.08%,21.28%
0,第14案,高雄市鼓山區,22096,43286,65382,3072,68454,114979,59.54%,19.22%
0,第14案,高雄市左營區,29870,64229,94099,4131,98230,161367,60.87%,18.51%
0,第14案,高雄市楠梓區,28203,58257,86460,5454,91914,153132,60.02%,18.42%
0,第14案,高雄市三民區,56428,107656,164084,7746,171830,289519,59.35%,19.49%
0,第14案,高雄市新興區,9020,16882,25902,1319,27221,44355,61.37%,20.34%
0,第14案,高雄市前金區,4649,9216,13865,685,14550,23928,60.81%,19.43%
0,第14案,高雄市苓雅區,28522,57208,85730,4100,89830,146786,61.2%,19.43%
0,第14案,高雄市前鎮區,29186,60498,89684,5513,95197,161797,58.84%,18.04%
0,第14案,高雄市旗津區,3934,8078,12012,969,12981,24860,52.22%,15.82%
0,第14案,高雄市小港區,24368,49715,74083,3952,78035,132733,58.79%,18.36%
0,第14案,高雄市鳳山區,55389,114830,170219,9270,179489,300510,59.73%,18.43%
0,第14案,高雄市林園區,9748,21186,30934,1974,32908,59129,55.65%,16.49%
0,第14案,高雄市大寮區,16625,35779,52404,3199,55603,97309,57.14%,17.08%
0,第14案,高雄市大樹區,5867,13398,19265,1310,20575,36772,55.95%,15.96%
0,第14案,高雄市大社區,5495,10662,16157,1062,17219,30046,57.31%,18.29%
0,第14案,高雄市仁武區,13145,28120,41265,1851,43116,73611,58.57%,17.86%
0,第14案,高雄市鳥松區,7872,14815,22687,1215,23902,39191,60.99%,20.09%
0,第14案,高雄市岡山區,14572,32998,47570,2532,50102,81244,61.67%,17.94%
0,第14案,高雄市橋頭區,6068,12780,18848,1400,20248,32565,62.18%,18.63%
0,第14案,高雄市燕巢區,4238,9634,13872,1058,14930,26012,57.4%,16.29%
0,第14案,高雄市田寮區,903,2007,2910,302,3212,6671,48.15%,13.54%
0,第14案,高雄市阿蓮區,3946,8606,12552,756,13308,24534,54.24%,16.08%
0,第14案,高雄市路竹區,7707,16540,24247,1715,25962,43850,59.21%,17.58%
0,第14案,高雄市湖內區,4290,9315,13605,808,14413,25729,56.02%,16.67%
0,第14案,高雄市茄萣區,4092,9081,13173,1016,14189,26212,54.13%,15.61%
0,第14案,高雄市永安區,2115,4960,7075,501,7576,12001,63.13%,17.62%
0,第14案,高雄市彌陀區,3231,6147,9378,837,10215,16487,61.96%,19.6%
0,第14案,高雄市梓官區,5333,11730,17063,1155,18218,31025,58.72%,17.19%
0,第14案,高雄市旗山區,5161,11400,16561,1326,17887,31996,55.9%,16.13%
0,第14案,高雄市美濃區,4763,13154,17917,1568,19485,35311,55.18%,13.49%
0,第14案,高雄市六龜區,1414,3476,4890,591,5481,11501,47.66%,12.29%
0,第14案,高雄市甲仙區,681,1759,2440,245,2685,5417,49.57%,12.57%
0,第14案,高雄市杉林區,1180,3386,4566,432,4998,10607,47.12%,11.12%
0,第14案,高雄市內門區,1561,4042,5603,614,6217,13002,47.82%,12.01%
0,第14案,高雄市茂林區,233,837,1070,43,1113,1615,68.92%,14.43%
0,第14案,高雄市桃源區,395,1376,1771,75,1846,3498,52.77%,11.29%
0,第14案,高雄市那瑪夏區,285,1201,1486,117,1603,2424,66.13%,11.76%
0,第14案,新竹縣,73718,166893,240611,11635,252246,445051,56.68%,16.56%
0,第14案,新竹縣竹北市,27093,49966,77059,2904,79963,137129,58.31%,19.76%
0,第14案,新竹縣竹東鎮,12175,28462,40637,1990,42627,78794,54.1%,15.45%
0,第14案,新竹縣新埔鎮,4323,11109,15432,870,16302,28894,56.42%,14.96%
0,第14案,新竹縣關西鎮,3623,9655,13278,786,14064,24712,56.91%,14.66%
0,第14案,新竹縣湖口鄉,9767,24243,34010,1712,35722,63511,56.25%,15.38%
0,第14案,新竹縣新豐鄉,7092,17354,24446,1199,25645,45790,56.01%,15.49%
0,第14案,新竹縣芎林鄉,2767,6855,9622,571,10193,17293,58.94%,16%
0,第14案,新竹縣橫山鄉,1624,4608,6232,479,6711,11346,59.15%,14.31%
0,第14案,新竹縣北埔鄉,1229,3165,4394,248,4642,8180,56.75%,15.02%
0,第14案,新竹縣寶山鄉,2262,4960,7222,347,7569,12973,58.34%,17.44%
0,第14案,新竹縣峨眉鄉,689,2114,2803,253,3056,5068,60.3%,13.6%
0,第14案,新竹縣尖石鄉,681,2889,3570,198,3768,7364,51.17%,9.25%
0,第14案,新竹縣五峰鄉,393,1513,1906,78,1984,3997,49.64%,9.83%
0,第14案,苗栗縣,69712,177248,246960,15666,262626,461580,56.9%,15.1%
0,第14案,苗栗縣苗栗市,11499,29449,40948,2019,42967,74249,57.87%,15.49%
0,第14案,苗栗縣苑裡鎮,5758,15032,20790,1610,22400,38890,57.6%,14.81%
0,第14案,苗栗縣通霄鎮,4317,10427,14744,1336,16080,29709,54.13%,14.53%
0,第14案,苗栗縣竹南鎮,11195,25219,36414,1980,38394,68528,56.03%,16.34%
0,第14案,苗栗縣頭份市,12822,32287,45109,2293,47402,83617,56.69%,15.33%
0,第14案,苗栗縣後龍鎮,4624,11173,15797,1316,17113,30948,55.3%,14.94%
0,第14案,苗栗縣卓蘭鎮,2247,5873,8120,567,8687,14772,58.81%,15.21%
0,第14案,苗栗縣大湖鄉,1679,4573,6252,513,6765,12653,53.47%,13.27%
0,第14案,苗栗縣公館鄉,4235,11312,15547,1169,16716,28318,59.03%,14.96%
0,第14案,苗栗縣銅鑼鄉,2188,5976,8164,486,8650,15424,56.08%,14.19%
0,第14案,苗栗縣南庄鄉,1088,2956,4044,295,4339,8784,49.4%,12.39%
0,第14案,苗栗縣頭屋鄉,1586,4187,5773,349,6122,9390,65.2%,16.89%
0,第14案,苗栗縣三義鄉,1971,5796,7767,381,8148,13889,58.67%,14.19%
0,第14案,苗栗縣西湖鄉,927,2377,3304,230,3534,6382,55.37%,14.53%
0,第14案,苗栗縣造橋鄉,1613,4303,5916,503,6419,11027,58.21%,14.63%
0,第14案,苗栗縣三灣鄉,800,2345,3145,236,3381,5852,57.78%,13.67%
0,第14案,苗栗縣獅潭鄉,436,1421,1857,183,2040,3968,51.41%,10.99%
0,第14案,苗栗縣泰安鄉,727,2542,3269,200,3469,5180,66.97%,14.03%
0,第14案,彰化縣,169785,406975,576760,37374,614134,1066994,57.56%,15.91%
0,第14案,彰化縣彰化市,35013,74892,109905,5771,115676,190995,60.56%,18.33%
0,第14案,彰化縣鹿港鎮,10989,27443,38432,2624,41056,70505,58.23%,15.59%
0,第14案,彰化縣和美鎮,12440,28280,40720,2208,42928,75286,57.02%,16.52%
0,第14案,彰化縣線西鄉,2540,5284,7824,561,8385,14065,59.62%,18.06%
0,第14案,彰化縣伸港鄉,4690,11464,16154,1123,17277,30407,56.82%,15.42%
0,第14案,彰化縣福興鄉,5670,14443,20113,1517,21630,39745,54.42%,14.27%
0,第14案,彰化縣秀水鄉,5339,12780,18119,1157,19276,32394,59.5%,16.48%
0,第14案,彰化縣花壇鄉,6356,15329,21685,1327,23012,38924,59.12%,16.33%
0,第14案,彰化縣芬園鄉,3275,7341,10616,775,11391,20408,55.82%,16.05%
0,第14案,彰化縣員林市,16826,38432,55258,2885,58143,102028,56.99%,16.49%
0,第14案,彰化縣溪湖鎮,7098,17714,24812,1524,26336,45147,58.33%,15.72%
0,第14案,彰化縣田中鎮,5233,13929,19162,1370,20532,35391,58.01%,14.79%
0,第14案,彰化縣大村鄉,4826,12656,17482,1082,18564,31492,58.95%,15.32%
0,第14案,彰化縣埔鹽鄉,3951,11787,15738,1185,16923,28026,60.38%,14.1%
0,第14案,彰化縣埔心鄉,4971,12155,17126,1166,18292,29642,61.71%,16.77%
0,第14案,彰化縣永靖鄉,5312,12160,17472,1183,18655,31239,59.72%,17%
0,第14案,彰化縣社頭鄉,5559,14208,19767,1223,20990,36306,57.81%,15.31%
0,第14案,彰化縣二水鄉,2210,5233,7443,631,8074,13339,60.53%,16.57%
0,第14案,彰化縣北斗鎮,4468,10677,15145,1019,16164,27593,58.58%,16.19%
0,第14案,彰化縣二林鎮,5654,15454,21108,1588,22696,42976,52.81%,13.16%
0,第14案,彰化縣田尾鄉,3604,9306,12910,861,13771,23179,59.41%,15.55%
0,第14案,彰化縣埤頭鄉,3697,9130,12827,1227,14054,25677,54.73%,14.4%
0,第14案,彰化縣芳苑鄉,3302,9846,13148,1267,14415,29291,49.21%,11.27%
0,第14案,彰化縣大城鄉,1268,3990,5258,495,5753,14713,39.1%,8.62%
0,第14案,彰化縣竹塘鄉,1708,4713,6421,551,6972,12821,54.38%,13.32%
0,第14案,彰化縣溪州鄉,3786,8329,12115,1054,13169,25405,51.84%,14.9%
0,第14案,南投縣,64424,169616,234040,14360,248400,427089,58.16%,15.08%
0,第14案,南投縣南投市,13599,35060,48659,2561,51220,84328,60.74%,16.13%
0,第14案,南投縣埔里鎮,9897,27617,37514,2304,39818,68763,57.91%,14.39%
0,第14案,南投縣草屯鎮,13144,32838,45982,2329,48311,82922,58.26%,15.85%
0,第14案,南投縣竹山鎮,6548,17847,24395,1714,26109,47034,55.51%,13.92%
0,第14案,南投縣集集鎮,1468,3726,5194,385,5579,9611,58.05%,15.27%
0,第14案,南投縣名間鄉,5059,13700,18759,1355,20114,33408,60.21%,15.14%
0,第14案,南投縣鹿谷鄉,2541,5431,7972,552,8524,15941,53.47%,15.94%
0,第14案,南投縣中寮鄉,1881,5238,7119,518,7637,13181,57.94%,14.27%
0,第14案,南投縣魚池鄉,2215,4904,7119,507,7626,13958,54.64%,15.87%
0,第14案,南投縣國姓鄉,2278,6513,8791,613,9404,16597,56.66%,13.73%
0,第14案,南投縣水里鄉,2209,5887,8096,564,8660,15458,56.02%,14.29%
0,第14案,南投縣信義鄉,1752,5884,7636,583,8219,13299,61.8%,13.17%
0,第14案,南投縣仁愛鄉,1833,4971,6804,375,7179,12589,57.03%,14.56%
0,第14案,雲林縣,83844,196025,279869,22541,302410,584480,51.74%,14.35%
0,第14案,雲林縣斗六市,14769,34352,49121,2328,51449,89761,57.32%,16.45%
0,第14案,雲林縣斗南鎮,6245,14041,20286,1395,21681,38138,56.85%,16.37%
0,第14案,雲林縣虎尾鎮,8894,20574,29468,1670,31138,58167,53.53%,15.29%
0,第14案,雲林縣西螺鎮,5739,12903,18642,1609,20251,38142,53.09%,15.05%
0,第14案,雲林縣土庫鎮,3521,8220,11741,1105,12846,24412,52.62%,14.42%
0,第14案,雲林縣北港鎮,5355,11642,16997,1559,18556,33958,54.64%,15.77%
0,第14案,雲林縣古坑鄉,3823,9653,13476,1066,14542,27477,52.92%,13.91%
0,第14案,雲林縣大埤鄉,2326,5471,7797,685,8482,16509,51.38%,14.09%
0,第14案,雲林縣莿桐鄉,3806,8512,12318,1193,13511,24570,54.99%,15.49%
0,第14案,雲林縣林內鄉,2451,5524,7975,845,8820,15551,56.72%,15.76%
0,第14案,雲林縣二崙鄉,3016,7007,10023,1122,11145,23367,47.7%,12.91%
0,第14案,雲林縣崙背鄉,2900,6510,9410,829,10239,21050,48.64%,13.78%
0,第14案,雲林縣麥寮鄉,4892,11932,16824,1402,18226,37119,49.1%,13.18%
0,第14案,雲林縣東勢鄉,1805,4192,5997,600,6597,13239,49.83%,13.63%
0,第14案,雲林縣褒忠鄉,1690,3767,5457,410,5867,11381,51.55%,14.85%
0,第14案,雲林縣臺西鄉,2308,6511,8819,862,9681,21125,45.83%,10.93%
0,第14案,雲林縣元長鄉,2580,6422,9002,848,9850,22830,43.14%,11.3%
0,第14案,雲林縣四湖鄉,2046,5442,7488,800,8288,20983,39.5%,9.75%
0,第14案,雲林縣口湖鄉,2889,7343,10232,1240,11472,24193,47.42%,11.94%
0,第14案,雲林縣水林鄉,2789,6007,8796,973,9769,22508,43.4%,12.39%
0,第14案,嘉義縣,61462,144616,206078,18516,224594,442775,50.72%,13.88%
0,第14案,嘉義縣太保市,4847,10763,15610,1198,16808,31568,53.24%,15.35%
0,第14案,嘉義縣朴子市,5003,11776,16779,1431,18210,35191,51.75%,14.22%
0,第14案,嘉義縣布袋鎮,2878,7679,10557,1111,11668,23965,48.69%,12.01%
0,第14案,嘉義縣大林鎮,3920,9033,12953,988,13941,26922,51.78%,14.56%
0,第14案,嘉義縣民雄鄉,9608,20757,30365,2454,32819,61209,53.62%,15.7%
0,第14案,嘉義縣溪口鄉,1945,4013,5958,710,6668,13105,50.88%,14.84%
0,第14案,嘉義縣新港鄉,4181,9079,13260,1436,14696,27342,53.75%,15.29%
0,第14案,嘉義縣六腳鄉,2355,5572,7927,846,8773,20821,42.14%,11.31%
0,第14案,嘉義縣東石鄉,2032,5889,7921,963,8884,21915,40.54%,9.27%
0,第14案,嘉義縣義竹鄉,2239,5294,7533,865,8398,16647,50.45%,13.45%
0,第14案,嘉義縣鹿草鄉,1839,3973,5812,755,6567,13937,47.12%,13.2%
0,第14案,嘉義縣水上鄉,6509,14932,21441,1798,23239,43857,52.99%,14.84%
0,第14案,嘉義縣中埔鄉,5013,11948,16961,1386,18347,39139,46.88%,12.81%
0,第14案,嘉義縣竹崎鄉,4207,10831,15038,1092,16130,31228,51.65%,13.47%
0,第14案,嘉義縣梅山鄉,2473,6061,8534,856,9390,17083,54.97%,14.48%
0,第14案,嘉義縣番路鄉,1364,3923,5287,394,5681,10156,55.94%,13.43%
0,第14案,嘉義縣大埔鄉,612,1454,2066,121,2187,3999,54.69%,15.3%
0,第14案,嘉義縣阿里山鄉,437,1639,2076,112,2188,4691,46.64%,9.32%
0,第14案,屏東縣,105349,238235,343584,28287,371871,711720,52.25%,14.8%
0,第14案,屏東縣屏東市,26847,59054,85901,4615,90516,170148,53.2%,15.78%
0,第14案,屏東縣潮州鎮,6776,15936,22712,1538,24250,46444,52.21%,14.59%
0,第14案,屏東縣東港鎮,5699,13456,19155,1835,20990,39495,53.15%,14.43%
0,第14案,屏東縣恆春鎮,3613,7664,11277,786,12063,25661,47.01%,14.08%
0,第14案,屏東縣萬丹鄉,6538,14763,21301,1917,23218,43478,53.4%,15.04%
0,第14案,屏東縣長治鄉,4391,8870,13261,1202,14463,26256,55.08%,16.72%
0,第14案,屏東縣麟洛鄉,1695,3660,5355,371,5726,9970,57.43%,17%
0,第14案,屏東縣九如鄉,2870,6438,9308,1113,10421,19132,54.47%,15%
0,第14案,屏東縣里港鄉,3647,7278,10925,1225,12150,22128,54.91%,16.48%
0,第14案,屏東縣鹽埔鄉,3263,7500,10763,880,11643,22402,51.97%,14.57%
0,第14案,屏東縣高樹鄉,3064,6504,9568,1117,10685,21697,49.25%,14.12%
0,第14案,屏東縣萬巒鄉,2591,5675,8266,900,9166,17945,51.08%,14.44%
0,第14案,屏東縣內埔鄉,6425,14587,21012,1607,22619,47558,47.56%,13.51%
0,第14案,屏東縣竹田鄉,2437,5438,7875,865,8740,15353,56.93%,15.87%
0,第14案,屏東縣新埤鄉,1201,2953,4154,407,4561,9033,50.49%,13.3%
0,第14案,屏東縣枋寮鄉,2916,7210,10126,1218,11344,21394,53.02%,13.63%
0,第14案,屏東縣新園鄉,4401,10267,14668,1535,16203,30706,52.77%,14.33%
0,第14案,屏東縣崁頂鄉,1904,3962,5866,570,6436,12270,52.45%,15.52%
0,第14案,屏東縣林邊鄉,2351,5531,7882,860,8742,15691,55.71%,14.98%
0,第14案,屏東縣南州鄉,1592,2968,4560,462,5022,9479,52.98%,16.8%
0,第14案,屏東縣佳冬鄉,2422,5049,7471,981,8452,17063,49.53%,14.19%
0,第14案,屏東縣琉球鄉,1062,3341,4403,345,4748,10706,44.35%,9.92%
0,第14案,屏東縣車城鄉,968,1913,2881,266,3147,7595,41.44%,12.75%
0,第14案,屏東縣滿州鄉,887,1982,2869,210,3079,7206,42.73%,12.31%
0,第14案,屏東縣枋山鄉,682,1568,2250,212,2462,4856,50.7%,14.04%
0,第14案,屏東縣三地門鄉,938,2463,3401,230,3631,6373,56.97%,14.72%
0,第14案,屏東縣霧臺鄉,414,1291,1705,111,1816,2950,61.56%,14.03%
0,第14案,屏東縣瑪家鄉,862,2507,3369,199,3568,5663,63.01%,15.22%
0,第14案,屏東縣泰武鄉,631,1948,2579,228,2807,4344,64.62%,14.53%
0,第14案,屏東縣來義鄉,788,2692,3480,254,3734,6257,59.68%,12.59%
0,第14案,屏東縣春日鄉,432,897,1329,52,1381,3923,35.2%,11.01%
0,第14案,屏東縣獅子鄉,515,1674,2189,100,2289,4230,54.11%,12.17%
0,第14案,屏東縣牡丹鄉,527,1196,1723,76,1799,4314,41.7%,12.22%
0,第14案,宜蘭縣,66039,133819,199858,14588,214446,386089,55.54%,17.1%
0,第14案,宜蘭縣宜蘭市,14241,28110,42351,2473,44824,79167,56.62%,17.99%
0,第14案,宜蘭縣羅東鎮,10777,20418,31195,2004,33199,57686,57.55%,18.68%
0,第14案,宜蘭縣蘇澳鎮,5786,11967,17753,1621,19374,34512,56.14%,16.77%
0,第14案,宜蘭縣頭城鎮,4144,8579,12723,1078,13801,25135,54.91%,16.49%
0,第14案,宜蘭縣礁溪鄉,5114,10560,15674,1128,16802,31084,54.05%,16.45%
0,第14案,宜蘭縣壯圍鄉,3966,7329,11295,1116,12411,21447,57.87%,18.49%
0,第14案,宜蘭縣員山鄉,4660,9221,13881,1256,15137,28131,53.81%,16.57%
0,第14案,宜蘭縣冬山鄉,7599,15447,23046,1445,24491,45405,53.94%,16.74%
0,第14案,宜蘭縣五結鄉,5805,11661,17466,1252,18718,34892,53.65%,16.64%
0,第14案,宜蘭縣三星鄉,2905,6235,9140,848,9988,19051,52.43%,15.25%
0,第14案,宜蘭縣大同鄉,556,2141,2697,192,2889,4935,58.54%,11.27%
0,第14案,宜蘭縣南澳鄉,486,2151,2637,175,2812,4644,60.55%,10.47%
0,第14案,花蓮縣,36102,100144,136246,10129,146375,278059,52.64%,12.98%
0,第14案,花蓮縣花蓮市,12198,31255,43453,2228,45681,84807,53.86%,14.38%
0,第14案,花蓮縣鳳林鎮,1242,3638,4880,468,5348,9676,55.27%,12.84%
0,第14案,花蓮縣玉里鎮,2279,6432,8711,1083,9794,20650,47.43%,11.04%
0,第14案,花蓮縣新城鄉,2336,6293,8629,617,9246,17029,54.3%,13.72%
0,第14案,花蓮縣吉安鄉,9393,26662,36055,2081,38136,72116,52.88%,13.02%
0,第14案,花蓮縣壽豐鄉,2161,5885,8046,758,8804,15847,55.56%,13.64%
0,第14案,花蓮縣光復鄉,1246,3966,5212,669,5881,11417,51.51%,10.91%
0,第14案,花蓮縣豐濱鄉,485,1248,1733,273,2006,4395,45.64%,11.04%
0,第14案,花蓮縣瑞穗鄉,1029,3532,4561,516,5077,10279,49.39%,10.01%
0,第14案,花蓮縣富里鄉,913,2810,3723,434,4157,9065,45.86%,10.07%
0,第14案,花蓮縣秀林鄉,1602,4402,6004,449,6453,12562,51.37%,12.75%
0,第14案,花蓮縣萬榮鄉,667,2014,2681,262,2943,5269,55.86%,12.66%
0,第14案,花蓮縣卓溪鄉,551,2007,2558,291,2849,4947,57.59%,11.14%
0,第14案,臺東縣,23365,65685,89050,6940,95990,185996,51.61%,12.56%
0,第14案,臺東縣臺東市,12117,33290,45407,2640,48047,87803,54.72%,13.8%
0,第14案,臺東縣成功鎮,1189,4309,5498,649,6147,12426,49.47%,9.57%
0,第14案,臺東縣關山鎮,924,2596,3520,227,3747,7509,49.9%,12.31%
0,第14案,臺東縣卑南鄉,1956,5204,7160,708,7868,14976,52.54%,13.06%
0,第14案,臺東縣鹿野鄉,864,2044,2908,220,3128,6936,45.1%,12.46%
0,第14案,臺東縣池上鄉,818,2187,3005,301,3306,7162,46.16%,11.42%
0,第14案,臺東縣東河鄉,788,2203,2991,358,3349,7635,43.86%,10.32%
0,第14案,臺東縣長濱鄉,562,1793,2355,363,2718,6484,41.92%,8.67%
0,第14案,臺東縣太麻里鄉,1099,3268,4367,420,4787,9666,49.52%,11.37%
0,第14案,臺東縣大武鄉,621,1713,2334,376,2710,5266,51.46%,11.79%
0,第14案,臺東縣綠島鄉,481,1040,1521,58,1579,3579,44.12%,13.44%
0,第14案,臺東縣海端鄉,351,1281,1632,124,1756,3278,53.57%,10.71%
0,第14案,臺東縣延平鄉,352,1135,1487,117,1604,2930,54.74%,12.01%
0,第14案,臺東縣金峰鄉,453,1217,1670,145,1815,3028,59.94%,14.96%
0,第14案,臺東縣達仁鄉,373,1312,1685,144,1829,3137,58.3%,11.89%
0,第14案,臺東縣蘭嶼鄉,417,1093,1510,90,1600,4181,38.27%,9.97%
0,第14案,澎湖縣,11008,27052,38060,2692,40752,90405,45.08%,12.18%
0,第14案,澎湖縣馬公市,7199,17432,24631,1522,26153,53655,48.74%,13.42%
0,第14案,澎湖縣湖西鄉,1445,3701,5146,378,5524,12741,43.36%,11.34%
0,第14案,澎湖縣白沙鄉,886,2483,3369,287,3656,8625,42.39%,10.27%
0,第14案,澎湖縣西嶼鄉,666,1618,2284,270,2554,7382,34.6%,9.02%
0,第14案,澎湖縣望安鄉,495,1193,1688,156,1844,4628,39.84%,10.7%
0,第14案,澎湖縣七美鄉,317,625,942,79,1021,3374,30.26%,9.4%
0,第14案,金門縣,10414,31439,41853,2076,43929,122695,35.8%,8.49%
0,第14案,金門縣金城鎮,3216,9370,12586,653,13239,37815,35.01%,8.5%
0,第14案,金門縣金沙鎮,1191,5049,6240,336,6576,18560,35.43%,6.42%
0,第14案,金門縣金湖鎮,2121,6928,9049,452,9501,25915,36.66%,8.18%
0,第14案,金門縣金寧鄉,3026,6725,9751,438,10189,28162,36.18%,10.74%
0,第14案,金門縣烈嶼鄉,823,3243,4066,193,4259,11676,36.48%,7.05%
0,第14案,金門縣烏坵鄉,37,124,161,4,165,567,29.1%,6.53%
0,第14案,連江縣,1493,4083,5576,183,5759,11205,51.4%,13.32%
0,第14案,連江縣南竿鄉,790,2397,3187,101,3288,6461,50.89%,12.23%
0,第14案,連江縣北竿鄉,247,829,1076,34,1110,2125,52.24%,11.62%
0,第14案,連江縣莒光鄉,185,572,757,27,784,1481,52.94%,12.49%
0,第14案,連江縣東引鄉,271,285,556,21,577,1138,50.7%,23.81%
0,第14案,基隆市,53224,103741,156965,8372,165337,320030,51.66%,16.63%
0,第14案,基隆市中正區,6497,13633,20130,1355,21485,45545,47.17%,14.27%
0,第14案,基隆市七堵區,7825,15342,23167,1340,24507,46256,52.98%,16.92%
0,第14案,基隆市暖暖區,5920,11065,16985,713,17698,33225,53.27%,17.82%
0,第14案,基隆市仁愛區,6151,12100,18251,1309,19560,36738,53.24%,16.74%
0,第14案,基隆市中山區,6749,13396,20145,1141,21286,41856,50.86%,16.12%
0,第14案,基隆市安樂區,12394,22700,35094,1570,36664,70396,52.08%,17.61%
0,第14案,基隆市信義區,7688,15505,23193,944,24137,46014,52.46%,16.71%
0,第14案,新竹市,65851,124511,190362,8887,199249,351775,56.64%,18.72%
0,第14案,新竹市東區,32694,57138,89832,3741,93573,163757,57.14%,19.96%
0,第14案,新竹市北區,22029,43977,66006,3196,69202,123122,56.21%,17.89%
0,第14案,新竹市香山區,11128,23396,34524,1950,36474,64896,56.2%,17.15%
0,第14案,嘉義市,37776,77841,115617,6009,121626,221553,54.9%,17.05%
0,第14案,嘉義市東區,17757,34768,52525,2599,55124,100647,54.77%,17.64%
0,第14案,嘉義市西區,20019,43073,63092,3410,66502,120906,55%,16.56%
0,第15案,全國,3507665,6805171,10312836,619001,10931837,19757067,55.33%,17.75%
0,第15案,臺北市,479771,751265,1231036,58945,1289981,2228430,57.89%,21.53%
0,第15案,臺北市松山區,37298,58829,96127,4313,100440,169278,59.33%,22.03%
0,第15案,臺北市信義區,40135,65500,105635,4827,110462,190444,58%,21.07%
0,第15案,臺北市大安區,54598,85851,140449,5548,145997,252645,57.79%,21.61%
0,第15案,臺北市中山區,42578,64018,106596,5211,111807,195148,57.29%,21.82%
0,第15案,臺北市中正區,27634,44386,72020,3023,75043,128292,58.49%,21.54%
0,第15案,臺北市大同區,24094,34885,58979,3537,62516,107557,58.12%,22.4%
0,第15案,臺北市萬華區,33238,52945,86183,5302,91485,164020,55.78%,20.26%
0,第15案,臺北市文山區,49133,81140,130273,5773,136046,227211,59.88%,21.62%
0,第15案,臺北市南港區,22312,34517,56829,2479,59308,101907,58.2%,21.89%
0,第15案,臺北市內湖區,52518,80236,132754,5283,138037,236824,58.29%,22.18%
0,第15案,臺北市士林區,51855,79244,131099,7642,138741,241854,57.37%,21.44%
0,第15案,臺北市北投區,44378,69714,114092,6007,120099,213250,56.32%,20.81%
0,第15案,新北市,631350,1127654,1759004,107872,1866876,3375513,55.31%,18.7%
0,第15案,新北市板橋區,89876,156175,246051,16356,262407,463411,56.63%,19.39%
0,第15案,新北市三重區,64488,107248,171736,12610,184346,329846,55.89%,19.55%
0,第15案,新北市中和區,65604,122740,188344,9839,198183,355978,55.67%,18.43%
0,第15案,新北市永和區,37605,68429,106034,5143,111177,187798,59.2%,20.02%
0,第15案,新北市新莊區,67789,117471,185260,11395,196655,344981,57%,19.65%
0,第15案,新北市新店區,48345,93966,142311,7075,149386,264053,56.57%,18.31%
0,第15案,新北市樹林區,28180,51144,79324,4931,84255,152102,55.39%,18.53%
0,第15案,新北市鶯歌區,12659,23037,35696,2140,37836,71645,52.81%,17.67%
0,第15案,新北市三峽區,16312,30727,47039,2757,49796,94291,52.81%,17.3%
0,第15案,新北市淡水區,26552,47418,73970,3662,77632,147272,52.71%,18.03%
0,第15案,新北市汐止區,32285,54856,87141,4848,91989,173831,52.92%,18.57%
0,第15案,新北市瑞芳區,5235,10465,15700,1265,16965,35036,48.42%,14.94%
0,第15案,新北市土城區,37665,66049,103714,6692,110406,200783,54.99%,18.76%
0,第15案,新北市蘆洲區,31191,52571,83762,5891,89653,167457,53.54%,18.63%
0,第15案,新北市五股區,12868,23458,36326,2422,38748,72443,53.49%,17.76%
0,第15案,新北市泰山區,11793,21896,33689,1893,35582,64252,55.38%,18.35%
0,第15案,新北市林口區,16881,29035,45916,2376,48292,86203,56.02%,19.58%
0,第15案,新北市深坑區,3861,6894,10755,625,11380,20624,55.18%,18.72%
0,第15案,新北市石碇區,1094,2082,3176,293,3469,6861,50.56%,15.95%
0,第15案,新北市坪林區,898,1829,2727,291,3018,5891,51.23%,15.24%
0,第15案,新北市三芝區,3186,5837,9023,741,9764,20119,48.53%,15.84%
0,第15案,新北市石門區,1579,3331,4910,541,5451,10528,51.78%,15%
0,第15案,新北市八里區,5690,10721,16411,1076,17487,32970,53.04%,17.26%
0,第15案,新北市平溪區,547,1297,1844,233,2077,4321,48.07%,12.66%
0,第15案,新北市雙溪區,1037,2472,3509,374,3883,7999,48.54%,12.96%
0,第15案,新北市貢寮區,1418,3049,4467,482,4949,11279,43.88%,12.57%
0,第15案,新北市金山區,3271,5466,8737,890,9627,18978,50.73%,17.24%
0,第15案,新北市萬里區,2609,6072,8681,926,9607,19297,49.78%,13.52%
0,第15案,新北市烏來區,832,1919,2751,105,2856,5264,54.26%,15.81%
0,第15案,桃園市,295646,590939,886585,43820,930405,1801823,51.64%,16.41%
0,第15案,桃園市桃園區,63229,111711,174940,7703,182643,359790,50.76%,17.57%
0,第15案,桃園市中壢區,55628,113277,168905,7506,176411,334402,52.75%,16.64%
0,第15案,桃園市大溪區,12329,26181,38510,2824,41334,78285,52.8%,15.75%
0,第15案,桃園市楊梅區,21210,46233,67443,3207,70650,137917,51.23%,15.38%
0,第15案,桃園市蘆竹區,21787,40963,62750,3168,65918,129252,51%,16.86%
0,第15案,桃園市大園區,11444,23644,35088,1798,36886,73900,49.91%,15.49%
0,第15案,桃園市龜山區,22419,39443,61862,3057,64919,131702,49.29%,17.02%
0,第15案,桃園市八德區,26246,52650,78896,4541,83437,165065,50.55%,15.9%
0,第15案,桃園市龍潭區,15518,36190,51708,2635,54343,101574,53.5%,15.28%
0,第15案,桃園市平鎮區,29969,63734,93703,4046,97749,183560,53.25%,16.33%
0,第15案,桃園市新屋區,6408,15202,21610,1394,23004,41461,55.48%,15.46%
0,第15案,桃園市觀音區,8475,17670,26145,1647,27792,55149,50.39%,15.37%
0,第15案,桃園市復興區,984,4041,5025,294,5319,9766,54.46%,10.08%
0,第15案,臺中市,411320,850532,1261852,71273,1333125,2295642,58.07%,17.92%
0,第15案,臺中市中區,2487,5268,7755,485,8240,14696,56.07%,16.92%
0,第15案,臺中市東區,11829,23874,35703,2239,37942,64291,59.02%,18.4%
0,第15案,臺中市南區,20975,39392,60367,3321,63688,103643,61.45%,20.24%
0,第15案,臺中市西區,19150,34098,53248,2543,55791,95040,58.7%,20.15%
0,第15案,臺中市北區,23371,44261,67632,2943,70575,124621,56.63%,18.75%
0,第15案,臺中市西屯區,35684,66785,102469,4496,106965,183814,58.19%,19.41%
0,第15案,臺中市南屯區,27215,51229,78444,3663,82107,135448,60.62%,20.09%
0,第15案,臺中市北屯區,41689,83227,124916,5529,130445,227720,57.28%,18.31%
0,第15案,臺中市豐原區,25365,52434,77799,4495,82294,136658,60.22%,18.56%
0,第15案,臺中市東勢區,6696,16783,23479,1855,25334,43181,58.67%,15.51%
0,第15案,臺中市大甲區,10769,23336,34105,2368,36473,63069,57.83%,17.07%
0,第15案,臺中市清水區,12574,26528,39102,2788,41890,71528,58.56%,17.58%
0,第15案,臺中市沙鹿區,12711,27332,40043,2280,42323,74207,57.03%,17.13%
0,第15案,臺中市梧棲區,7915,17312,25227,1665,26892,47040,57.17%,16.83%
0,第15案,臺中市后里區,7622,16964,24586,1666,26252,44962,58.39%,16.95%
0,第15案,臺中市神岡區,9121,21157,30278,2144,32422,54565,59.42%,16.72%
0,第15案,臺中市潭子區,15257,33803,49060,2572,51632,89487,57.7%,17.05%
0,第15案,臺中市大雅區,13441,28615,42056,2356,44412,77189,57.54%,17.41%
0,第15案,臺中市新社區,2984,7517,10501,684,11185,20860,53.62%,14.3%
0,第15案,臺中市石岡區,2109,4964,7073,552,7625,12880,59.2%,16.37%
0,第15案,臺中市外埔區,4102,10757,14859,1018,15877,27059,58.68%,15.16%
0,第15案,臺中市大安區,2665,6258,8923,829,9752,16520,59.03%,16.13%
0,第15案,臺中市烏日區,10735,23059,33794,2375,36169,61705,58.62%,17.4%
0,第15案,臺中市大肚區,7860,18142,26002,1772,27774,47457,58.52%,16.56%
0,第15案,臺中市龍井區,10744,23229,33973,2116,36089,63584,56.76%,16.9%
0,第15案,臺中市霧峰區,9513,21777,31290,2297,33587,55225,60.82%,17.23%
0,第15案,臺中市太平區,25949,55823,81772,4731,86503,157926,54.77%,16.43%
0,第15案,臺中市大里區,29508,62260,91768,5115,96883,171769,56.4%,17.18%
0,第15案,臺中市和平區,1280,4348,5628,376,6004,9498,63.21%,13.48%
0,第15案,臺南市,270957,502776,773733,45753,819486,1594821,51.38%,16.99%
0,第15案,臺南市新營區,10841,20018,30859,1481,32340,64949,49.79%,16.69%
0,第15案,臺南市鹽水區,3508,6307,9815,774,10589,22121,47.87%,15.86%
0,第15案,臺南市白河區,3476,6415,9891,838,10729,24894,43.1%,13.96%
0,第15案,臺南市柳營區,2872,5658,8530,766,9296,18804,49.44%,15.27%
0,第15案,臺南市後壁區,2975,5775,8750,867,9617,20841,46.14%,14.27%
0,第15案,臺南市東山區,2089,4204,6293,647,6940,18471,37.57%,11.31%
0,第15案,臺南市麻豆區,6621,10960,17581,1048,18629,37963,49.07%,17.44%
0,第15案,臺南市下營區,3091,5832,8923,913,9836,20947,46.96%,14.76%
0,第15案,臺南市六甲區,3197,5234,8431,830,9261,19144,48.38%,16.7%
0,第15案,臺南市官田區,3068,5351,8419,669,9088,18675,48.66%,16.43%
0,第15案,臺南市大內區,1171,2546,3717,426,4143,8654,47.87%,13.53%
0,第15案,臺南市佳里區,8520,16286,24806,1494,26300,50407,52.18%,16.9%
0,第15案,臺南市學甲區,3357,6682,10039,668,10707,22567,47.45%,14.88%
0,第15案,臺南市西港區,3256,6328,9584,568,10152,21564,47.08%,15.1%
0,第15案,臺南市七股區,2723,5757,8480,620,9100,19950,45.61%,13.65%
0,第15案,臺南市將軍區,2093,5114,7207,609,7816,17754,44.02%,11.79%
0,第15案,臺南市北門區,1139,2677,3816,260,4076,9925,41.07%,11.48%
0,第15案,臺南市新化區,6530,12063,18593,1427,20020,37296,53.68%,17.51%
0,第15案,臺南市善化區,7092,12087,19179,1284,20463,39950,51.22%,17.75%
0,第15案,臺南市新市區,5374,9981,15355,957,16312,30386,53.68%,17.69%
0,第15案,臺南市安定區,4337,8389,12726,919,13645,26104,52.27%,16.61%
0,第15案,臺南市山上區,928,1713,2641,228,2869,6511,44.06%,14.25%
0,第15案,臺南市玉井區,1665,3878,5543,462,6005,12357,48.6%,13.47%
0,第15案,臺南市楠西區,995,2544,3539,319,3858,8528,45.24%,11.67%
0,第15案,臺南市南化區,1054,2331,3385,323,3708,7786,47.62%,13.54%
0,第15案,臺南市左鎮區,501,1245,1746,232,1978,4418,44.77%,11.34%
0,第15案,臺南市仁德區,10819,21560,32379,2074,34453,64632,53.31%,16.74%
0,第15案,臺南市歸仁區,9988,18728,28716,1767,30483,57387,53.12%,17.4%
0,第15案,臺南市關廟區,4948,9878,14826,1096,15922,29913,53.23%,16.54%
0,第15案,臺南市龍崎區,485,1167,1652,150,1802,3713,48.53%,13.06%
0,第15案,臺南市永康區,34171,62863,97034,4478,101512,195001,52.06%,17.52%
0,第15案,臺南市東區,29616,50890,80506,3419,83925,153359,54.72%,19.31%
0,第15案,臺南市南區,18076,34732,52808,3166,55974,108650,51.52%,16.64%
0,第15案,臺南市北區,20680,36676,57356,2527,59883,110906,53.99%,18.65%
0,第15案,臺南市安南區,27446,51577,79023,4606,83629,159654,52.38%,17.19%
0,第15案,臺南市安平區,9779,17393,27172,1048,28220,55379,50.96%,17.66%
0,第15案,臺南市中西區,12476,21937,34413,1793,36206,65261,55.48%,19.12%
0,第15案,高雄市,436565,870018,1306583,78331,1384914,2353342,58.85%,18.55%
0,第15案,高雄市鹽埕區,4613,7277,11890,575,12465,21617,57.66%,21.34%
0,第15案,高雄市鼓山區,22321,42999,65320,3097,68417,114979,59.5%,19.41%
0,第15案,高雄市左營區,30605,63666,94271,3966,98237,161367,60.88%,18.97%
0,第15案,高雄市楠梓區,28585,57582,86167,5512,91679,153132,59.87%,18.67%
0,第15案,高雄市三民區,56856,106137,162993,8385,171378,289519,59.19%,19.64%
0,第15案,高雄市新興區,9445,16428,25873,1336,27209,44355,61.34%,21.29%
0,第15案,高雄市前金區,4776,8995,13771,738,14509,23928,60.64%,19.96%
0,第15案,高雄市苓雅區,29700,55824,85524,4183,89707,146786,61.11%,20.23%
0,第15案,高雄市前鎮區,30275,58765,89040,5948,94988,161797,58.71%,18.71%
0,第15案,高雄市旗津區,4223,7751,11974,1017,12991,24860,52.26%,16.99%
0,第15案,高雄市小港區,25181,48504,73685,4154,77839,132733,58.64%,18.97%
0,第15案,高雄市鳳山區,55770,113855,169625,9216,178841,300510,59.51%,18.56%
0,第15案,高雄市林園區,10174,20560,30734,2234,32968,59129,55.76%,17.21%
0,第15案,高雄市大寮區,16588,35551,52139,3391,55530,97309,57.07%,17.05%
0,第15案,高雄市大樹區,6166,13003,19169,1427,20596,36772,56.01%,16.77%
0,第15案,高雄市大社區,5753,10353,16106,1205,17311,30046,57.61%,19.15%
0,第15案,高雄市仁武區,13068,28094,41162,1991,43153,73611,58.62%,17.75%
0,第15案,高雄市鳥松區,7877,14661,22538,1305,23843,39191,60.84%,20.1%
0,第15案,高雄市岡山區,14680,32567,47247,2620,49867,81244,61.38%,18.07%
0,第15案,高雄市橋頭區,6321,12345,18666,1594,20260,32565,62.21%,19.41%
0,第15案,高雄市燕巢區,4398,9355,13753,1159,14912,26012,57.33%,16.91%
0,第15案,高雄市田寮區,897,1982,2879,325,3204,6671,48.03%,13.45%
0,第15案,高雄市阿蓮區,4353,8139,12492,792,13284,24534,54.15%,17.74%
0,第15案,高雄市路竹區,7908,16072,23980,1964,25944,43850,59.17%,18.03%
0,第15案,高雄市湖內區,4289,9148,13437,942,14379,25729,55.89%,16.67%
0,第15案,高雄市茄萣區,4510,8546,13056,1111,14167,26212,54.05%,17.21%
0,第15案,高雄市永安區,2323,4723,7046,527,7573,12001,63.1%,19.36%
0,第15案,高雄市彌陀區,2893,6438,9331,889,10220,16487,61.99%,17.55%
0,第15案,高雄市梓官區,5238,11624,16862,1304,18166,31025,58.55%,16.88%
0,第15案,高雄市旗山區,5654,10819,16473,1483,17956,31996,56.12%,17.67%
0,第15案,高雄市美濃區,4922,12858,17780,1641,19421,35311,55%,13.94%
0,第15案,高雄市六龜區,1451,3386,4837,642,5479,11501,47.64%,12.62%
0,第15案,高雄市甲仙區,706,1702,2408,279,2687,5417,49.6%,13.03%
0,第15案,高雄市杉林區,1437,2898,4335,460,4795,10607,45.21%,13.55%
0,第15案,高雄市內門區,1695,3965,5660,645,6305,13002,48.49%,13.04%
0,第15案,高雄市茂林區,246,812,1058,52,1110,1615,68.73%,15.23%
0,第15案,高雄市桃源區,385,1450,1835,100,1935,3498,55.32%,11.01%
0,第15案,高雄市那瑪夏區,283,1184,1467,122,1589,2424,65.55%,11.67%
0,第15案,新竹縣,77180,163313,240493,11783,252276,445051,56.68%,17.34%
0,第15案,新竹縣竹北市,27936,49115,77051,2874,79925,137129,58.28%,20.37%
0,第15案,新竹縣竹東鎮,12563,28093,40656,1955,42611,78794,54.08%,15.94%
0,第15案,新竹縣新埔鎮,4611,10817,15428,889,16317,28894,56.47%,15.96%
0,第15案,新竹縣關西鎮,3759,9450,13209,834,14043,24712,56.83%,15.21%
0,第15案,新竹縣湖口鄉,10422,23740,34162,1657,35819,63511,56.4%,16.41%
0,第15案,新竹縣新豐鄉,7296,17099,24395,1239,25634,45790,55.98%,15.93%
0,第15案,新竹縣芎林鄉,2855,6702,9557,645,10202,17293,58.99%,16.51%
0,第15案,新竹縣橫山鄉,1742,4507,6249,452,6701,11346,59.06%,15.35%
0,第15案,新竹縣北埔鄉,1549,2847,4396,238,4634,8180,56.65%,18.94%
0,第15案,新竹縣寶山鄉,2608,4591,7199,410,7609,12973,58.65%,20.1%
0,第15案,新竹縣峨眉鄉,742,2039,2781,279,3060,5068,60.38%,14.64%
0,第15案,新竹縣尖石鄉,710,2826,3536,217,3753,7364,50.96%,9.64%
0,第15案,新竹縣五峰鄉,387,1487,1874,94,1968,3997,49.24%,9.68%
0,第15案,苗栗縣,74809,172173,246982,15638,262620,461580,56.9%,16.21%
0,第15案,苗栗縣苗栗市,12854,28018,40872,1971,42843,74249,57.7%,17.31%
0,第15案,苗栗縣苑裡鎮,6245,14548,20793,1583,22376,38890,57.54%,16.06%
0,第15案,苗栗縣通霄鎮,4556,10178,14734,1346,16080,29709,54.13%,15.34%
0,第15案,苗栗縣竹南鎮,11697,24847,36544,1967,38511,68528,56.2%,17.07%
0,第15案,苗栗縣頭份市,13417,31783,45200,2218,47418,83617,56.71%,16.05%
0,第15案,苗栗縣後龍鎮,5002,10779,15781,1327,17108,30948,55.28%,16.16%
0,第15案,苗栗縣卓蘭鎮,2341,5742,8083,604,8687,14772,58.81%,15.85%
0,第15案,苗栗縣大湖鄉,1898,4329,6227,534,6761,12653,53.43%,15%
0,第15案,苗栗縣公館鄉,4595,10963,15558,1176,16734,28318,59.09%,16.23%
0,第15案,苗栗縣銅鑼鄉,2346,5800,8146,502,8648,15424,56.07%,15.21%
0,第15案,苗栗縣南庄鄉,1189,2880,4069,270,4339,8784,49.4%,13.54%
0,第15案,苗栗縣頭屋鄉,1691,4087,5778,346,6124,9390,65.22%,18.01%
0,第15案,苗栗縣三義鄉,2166,5583,7749,402,8151,13889,58.69%,15.6%
0,第15案,苗栗縣西湖鄉,987,2288,3275,253,3528,6382,55.28%,15.47%
0,第15案,苗栗縣造橋鄉,1696,4224,5920,499,6419,11027,58.21%,15.38%
0,第15案,苗栗縣三灣鄉,855,2253,3108,280,3388,5852,57.89%,14.61%
0,第15案,苗栗縣獅潭鄉,497,1381,1878,161,2039,3968,51.39%,12.53%
0,第15案,苗栗縣泰安鄉,777,2490,3267,199,3466,5180,66.91%,15%
0,第15案,彰化縣,177421,398192,575613,38235,613848,1066994,57.53%,16.63%
0,第15案,彰化縣彰化市,35239,74545,109784,5749,115533,190995,60.49%,18.45%
0,第15案,彰化縣鹿港鎮,11517,26869,38386,2697,41083,70505,58.27%,16.34%
0,第15案,彰化縣和美鎮,12951,27751,40702,2235,42937,75286,57.03%,17.2%
0,第15案,彰化縣線西鄉,2323,5545,7868,507,8375,14065,59.54%,16.52%
0,第15案,彰化縣伸港鄉,4958,11141,16099,1159,17258,30407,56.76%,16.31%
0,第15案,彰化縣福興鄉,6368,13715,20083,1533,21616,39745,54.39%,16.02%
0,第15案,彰化縣秀水鄉,5578,12461,18039,1225,19264,32394,59.47%,17.22%
0,第15案,彰化縣花壇鄉,6224,15562,21786,1329,23115,38924,59.38%,15.99%
0,第15案,彰化縣芬園鄉,3045,7442,10487,885,11372,20408,55.72%,14.92%
0,第15案,彰化縣員林市,17321,38055,55376,2876,58252,102028,57.09%,16.98%
0,第15案,彰化縣溪湖鎮,7695,17023,24718,1567,26285,45147,58.22%,17.04%
0,第15案,彰化縣田中鎮,5778,13245,19023,1405,20428,35391,57.72%,16.33%
0,第15案,彰化縣大村鄉,5500,11990,17490,1089,18579,31492,59%,17.46%
0,第15案,彰化縣埔鹽鄉,4272,11478,15750,1191,16941,28026,60.45%,15.24%
0,第15案,彰化縣埔心鄉,5282,11827,17109,1294,18403,29642,62.08%,17.82%
0,第15案,彰化縣永靖鄉,5651,11781,17432,1192,18624,31239,59.62%,18.09%
0,第15案,彰化縣社頭鄉,5908,13849,19757,1224,20981,36306,57.79%,16.27%
0,第15案,彰化縣二水鄉,2152,5295,7447,672,8119,13339,60.87%,16.13%
0,第15案,彰化縣北斗鎮,4843,10218,15061,1070,16131,27593,58.46%,17.55%
0,第15案,彰化縣二林鎮,6416,14593,21009,1678,22687,42976,52.79%,14.93%
0,第15案,彰化縣田尾鄉,3867,8997,12864,893,13757,23179,59.35%,16.68%
0,第15案,彰化縣埤頭鄉,3871,8865,12736,1221,13957,25677,54.36%,15.08%
0,第15案,彰化縣芳苑鄉,3674,9277,12951,1350,14301,29291,48.82%,12.54%
0,第15案,彰化縣大城鄉,1381,3849,5230,515,5745,14713,39.05%,9.39%
0,第15案,彰化縣竹塘鄉,1832,4539,6371,581,6952,12821,54.22%,14.29%
0,第15案,彰化縣溪州鄉,3775,8280,12055,1098,13153,25405,51.77%,14.86%
0,第15案,南投縣,68393,165077,233470,14440,247910,427089,58.05%,16.01%
0,第15案,南投縣南投市,14491,34230,48721,2383,51104,84328,60.6%,17.18%
0,第15案,南投縣埔里鎮,10904,26454,37358,2295,39653,68763,57.67%,15.86%
0,第15案,南投縣草屯鎮,14396,31506,45902,2285,48187,82922,58.11%,17.36%
0,第15案,南投縣竹山鎮,7543,16737,24280,1780,26060,47034,55.41%,16.04%
0,第15案,南投縣集集鎮,1562,3642,5204,378,5582,9611,58.08%,16.25%
0,第15案,南投縣名間鄉,5405,13160,18565,1467,20032,33408,59.96%,16.18%
0,第15案,南投縣鹿谷鄉,2276,5778,8054,566,8620,15941,54.07%,14.28%
0,第15案,南投縣中寮鄉,1943,5131,7074,556,7630,13181,57.89%,14.74%
0,第15案,南投縣魚池鄉,2123,4942,7065,546,7611,13958,54.53%,15.21%
0,第15案,南投縣國姓鄉,2268,6510,8778,625,9403,16597,56.65%,13.67%
0,第15案,南投縣水里鄉,2326,5784,8110,569,8679,15458,56.15%,15.05%
0,第15案,南投縣信義鄉,1461,6133,7594,602,8196,13299,61.63%,10.99%
0,第15案,南投縣仁愛鄉,1695,5070,6765,388,7153,12589,56.82%,13.46%
0,第15案,雲林縣,88127,190434,278561,23887,302448,584480,51.75%,15.08%
0,第15案,雲林縣斗六市,15497,33537,49034,2528,51562,89761,57.44%,17.26%
0,第15案,雲林縣斗南鎮,6583,13713,20296,1405,21701,38138,56.9%,17.26%
0,第15案,雲林縣虎尾鎮,9596,19755,29351,1753,31104,58167,53.47%,16.5%
0,第15案,雲林縣西螺鎮,6128,12384,18512,1819,20331,38142,53.3%,16.07%
0,第15案,雲林縣土庫鎮,3824,7891,11715,1166,12881,24412,52.77%,15.66%
0,第15案,雲林縣北港鎮,5486,11404,16890,1664,18554,33958,54.64%,16.16%
0,第15案,雲林縣古坑鄉,4164,9260,13424,1136,14560,27477,52.99%,15.15%
0,第15案,雲林縣大埤鄉,2538,5310,7848,671,8519,16509,51.6%,15.37%
0,第15案,雲林縣莿桐鄉,4027,8252,12279,1291,13570,24570,55.23%,16.39%
0,第15案,雲林縣林內鄉,2539,5386,7925,877,8802,15551,56.6%,16.33%
0,第15案,雲林縣二崙鄉,3275,6738,10013,1146,11159,23367,47.76%,14.02%
0,第15案,雲林縣崙背鄉,2880,6338,9218,927,10145,21050,48.19%,13.68%
0,第15案,雲林縣麥寮鄉,4927,11731,16658,1443,18101,37119,48.76%,13.27%
0,第15案,雲林縣東勢鄉,1761,4200,5961,625,6586,13239,49.75%,13.3%
0,第15案,雲林縣褒忠鄉,1790,3641,5431,430,5861,11381,51.5%,15.73%
0,第15案,雲林縣臺西鄉,2524,6237,8761,912,9673,21125,45.79%,11.95%
0,第15案,雲林縣元長鄉,2717,6177,8894,945,9839,22830,43.1%,11.9%
0,第15案,雲林縣四湖鄉,2192,5251,7443,829,8272,20983,39.42%,10.45%
0,第15案,雲林縣口湖鄉,2990,7195,10185,1280,11465,24193,47.39%,12.36%
0,第15案,雲林縣水林鄉,2689,6034,8723,1040,9763,22508,43.38%,11.95%
0,第15案,嘉義縣,65100,139182,204282,19875,224157,442775,50.63%,14.7%
0,第15案,嘉義縣太保市,5217,10385,15602,1236,16838,31568,53.34%,16.53%
0,第15案,嘉義縣朴子市,5426,11329,16755,1428,18183,35191,51.67%,15.42%
0,第15案,嘉義縣布袋鎮,3048,7395,10443,1180,11623,23965,48.5%,12.72%
0,第15案,嘉義縣大林鎮,4191,8594,12785,1117,13902,26922,51.64%,15.57%
0,第15案,嘉義縣民雄鄉,10079,19984,30063,2724,32787,61209,53.57%,16.47%
0,第15案,嘉義縣溪口鄉,2024,3870,5894,726,6620,13105,50.52%,15.44%
0,第15案,嘉義縣新港鄉,4330,8597,12927,1648,14575,27342,53.31%,15.84%
0,第15案,嘉義縣六腳鄉,2568,5282,7850,873,8723,20821,41.9%,12.33%
0,第15案,嘉義縣東石鄉,2179,5707,7886,985,8871,21915,40.48%,9.94%
0,第15案,嘉義縣義竹鄉,2458,5021,7479,910,8389,16647,50.39%,14.77%
0,第15案,嘉義縣鹿草鄉,1996,3726,5722,841,6563,13937,47.09%,14.32%
0,第15案,嘉義縣水上鄉,6712,14609,21321,1928,23249,43857,53.01%,15.3%
0,第15案,嘉義縣中埔鄉,5328,11537,16865,1466,18331,39139,46.84%,13.61%
0,第15案,嘉義縣竹崎鄉,4432,10473,14905,1194,16099,31228,51.55%,14.19%
0,第15案,嘉義縣梅山鄉,2612,5888,8500,875,9375,17083,54.88%,15.29%
0,第15案,嘉義縣番路鄉,1436,3778,5214,453,5667,10156,55.8%,14.14%
0,第15案,嘉義縣大埔鄉,634,1397,2031,157,2188,3999,54.71%,15.85%
0,第15案,嘉義縣阿里山鄉,430,1610,2040,134,2174,4691,46.34%,9.17%
0,第15案,屏東縣,113331,229686,343017,28411,371428,711720,52.19%,15.92%
0,第15案,屏東縣屏東市,29361,56512,85873,4547,90420,170148,53.14%,17.26%
0,第15案,屏東縣潮州鎮,7197,15460,22657,1559,24216,46444,52.14%,15.5%
0,第15案,屏東縣東港鎮,6062,13078,19140,1842,20982,39495,53.13%,15.35%
0,第15案,屏東縣恆春鎮,3668,7587,11255,822,12077,25661,47.06%,14.29%
0,第15案,屏東縣萬丹鄉,7211,14001,21212,1988,23200,43478,53.36%,16.59%
0,第15案,屏東縣長治鄉,4527,8662,13189,1270,14459,26256,55.07%,17.24%
0,第15案,屏東縣麟洛鄉,2021,3381,5402,362,5764,9970,57.81%,20.27%
0,第15案,屏東縣九如鄉,2950,6397,9347,1075,10422,19132,54.47%,15.42%
0,第15案,屏東縣里港鄉,3616,7226,10842,1218,12060,22128,54.5%,16.34%
0,第15案,屏東縣鹽埔鄉,3430,7284,10714,908,11622,22402,51.88%,15.31%
0,第15案,屏東縣高樹鄉,3246,6296,9542,1121,10663,21697,49.15%,14.96%
0,第15案,屏東縣萬巒鄉,2813,5417,8230,920,9150,17945,50.99%,15.68%
0,第15案,屏東縣內埔鄉,6775,14248,21023,1649,22672,47558,47.67%,14.25%
0,第15案,屏東縣竹田鄉,3162,4856,8018,812,8830,15353,57.51%,20.6%
0,第15案,屏東縣新埤鄉,1301,2812,4113,445,4558,9033,50.46%,14.4%
0,第15案,屏東縣枋寮鄉,3196,6773,9969,1214,11183,21394,52.27%,14.94%
0,第15案,屏東縣新園鄉,4787,9799,14586,1559,16145,30706,52.58%,15.59%
0,第15案,屏東縣崁頂鄉,2014,3865,5879,553,6432,12270,52.42%,16.41%
0,第15案,屏東縣林邊鄉,2763,5109,7872,849,8721,15691,55.58%,17.61%
0,第15案,屏東縣南州鄉,1618,2921,4539,476,5015,9479,52.91%,17.07%
0,第15案,屏東縣佳冬鄉,2520,4918,7438,988,8426,17063,49.38%,14.77%
0,第15案,屏東縣琉球鄉,1041,3387,4428,327,4755,10706,44.41%,9.72%
0,第15案,屏東縣車城鄉,1020,1844,2864,269,3133,7595,41.25%,13.43%
0,第15案,屏東縣滿州鄉,971,1913,2884,197,3081,7206,42.76%,13.47%
0,第15案,屏東縣枋山鄉,707,1563,2270,220,2490,4856,51.28%,14.56%
0,第15案,屏東縣三地門鄉,985,2381,3366,249,3615,6373,56.72%,15.46%
0,第15案,屏東縣霧臺鄉,433,1268,1701,108,1809,2950,61.32%,14.68%
0,第15案,屏東縣瑪家鄉,880,2505,3385,178,3563,5663,62.92%,15.54%
0,第15案,屏東縣泰武鄉,699,1915,2614,195,2809,4344,64.66%,16.09%
0,第15案,屏東縣來義鄉,822,2639,3461,271,3732,6257,59.65%,13.14%
0,第15案,屏東縣春日鄉,440,877,1317,43,1360,3923,34.67%,11.22%
0,第15案,屏東縣獅子鄉,525,1655,2180,93,2273,4230,53.74%,12.41%
0,第15案,屏東縣牡丹鄉,570,1137,1707,84,1791,4314,41.52%,13.21%
0,第15案,宜蘭縣,69188,130483,199671,14890,214561,386089,55.57%,17.92%
0,第15案,宜蘭縣宜蘭市,14997,27404,42401,2549,44950,79167,56.78%,18.94%
0,第15案,宜蘭縣羅東鎮,11312,19797,31109,2002,33111,57686,57.4%,19.61%
0,第15案,宜蘭縣蘇澳鎮,6130,11634,17764,1642,19406,34512,56.23%,17.76%
0,第15案,宜蘭縣頭城鎮,4332,8342,12674,1159,13833,25135,55.03%,17.23%
0,第15案,宜蘭縣礁溪鄉,5360,10197,15557,1238,16795,31084,54.03%,17.24%
0,第15案,宜蘭縣壯圍鄉,3935,7302,11237,1133,12370,21447,57.68%,18.35%
0,第15案,宜蘭縣員山鄉,4651,9182,13833,1333,15166,28131,53.91%,16.53%
0,第15案,宜蘭縣冬山鄉,8099,14995,23094,1420,24514,45405,53.99%,17.84%
0,第15案,宜蘭縣五結鄉,6188,11329,17517,1217,18734,34892,53.69%,17.73%
0,第15案,宜蘭縣三星鄉,3118,6076,9194,797,9991,19051,52.44%,16.37%
0,第15案,宜蘭縣大同鄉,528,2137,2665,217,2882,4935,58.4%,10.7%
0,第15案,宜蘭縣南澳鄉,538,2088,2626,183,2809,4644,60.49%,11.58%
0,第15案,花蓮縣,38850,97972,136822,9514,146336,278059,52.63%,13.97%
0,第15案,花蓮縣花蓮市,13072,30596,43668,2054,45722,84807,53.91%,15.41%
0,第15案,花蓮縣鳳林鎮,1327,3547,4874,466,5340,9676,55.19%,13.71%
0,第15案,花蓮縣玉里鎮,2402,6382,8784,997,9781,20650,47.37%,11.63%
0,第15案,花蓮縣新城鄉,2473,6193,8666,586,9252,17029,54.33%,14.52%
0,第15案,花蓮縣吉安鄉,10232,26015,36247,1847,38094,72116,52.82%,14.19%
0,第15案,花蓮縣壽豐鄉,2363,5703,8066,734,8800,15847,55.53%,14.91%
0,第15案,花蓮縣光復鄉,1345,3871,5216,674,5890,11417,51.59%,11.78%
0,第15案,花蓮縣豐濱鄉,520,1207,1727,271,1998,4395,45.46%,11.83%
0,第15案,花蓮縣瑞穗鄉,1135,3451,4586,509,5095,10279,49.57%,11.04%
0,第15案,花蓮縣富里鄉,1034,2693,3727,424,4151,9065,45.79%,11.41%
0,第15案,花蓮縣秀林鄉,1694,4326,6020,415,6435,12562,51.23%,13.49%
0,第15案,花蓮縣萬榮鄉,668,1986,2654,279,2933,5269,55.67%,12.68%
0,第15案,花蓮縣卓溪鄉,585,2002,2587,258,2845,4947,57.51%,11.83%
0,第15案,臺東縣,24813,62900,87713,8135,95848,185996,51.53%,13.34%
0,第15案,臺東縣臺東市,12992,31881,44873,3100,47973,87803,54.64%,14.8%
0,第15案,臺東縣成功鎮,1217,4110,5327,818,6145,12426,49.45%,9.79%
0,第15案,臺東縣關山鎮,1032,2442,3474,270,3744,7509,49.86%,13.74%
0,第15案,臺東縣卑南鄉,2112,4952,7064,803,7867,14976,52.53%,14.1%
0,第15案,臺東縣鹿野鄉,896,1965,2861,259,3120,6936,44.98%,12.92%
0,第15案,臺東縣池上鄉,894,2075,2969,336,3305,7162,46.15%,12.48%
0,第15案,臺東縣東河鄉,831,2088,2919,420,3339,7635,43.73%,10.88%
0,第15案,臺東縣長濱鄉,593,1717,2310,401,2711,6484,41.81%,9.15%
0,第15案,臺東縣太麻里鄉,1147,3148,4295,480,4775,9666,49.4%,11.87%
0,第15案,臺東縣大武鄉,636,1670,2306,399,2705,5266,51.37%,12.08%
0,第15案,臺東縣綠島鄉,467,1039,1506,73,1579,3579,44.12%,13.05%
0,第15案,臺東縣海端鄉,373,1226,1599,155,1754,3278,53.51%,11.38%
0,第15案,臺東縣延平鄉,335,1118,1453,146,1599,2930,54.57%,11.43%
0,第15案,臺東縣金峰鄉,454,1176,1630,170,1800,3028,59.45%,14.99%
0,第15案,臺東縣達仁鄉,382,1261,1643,188,1831,3137,58.37%,12.18%
0,第15案,臺東縣蘭嶼鄉,452,1032,1484,117,1601,4181,38.29%,10.81%
0,第15案,澎湖縣,11489,26451,37940,2808,40748,90405,45.07%,12.71%
0,第15案,澎湖縣馬公市,7572,17018,24590,1571,26161,53655,48.76%,14.11%
0,第15案,澎湖縣湖西鄉,1473,3640,5113,407,5520,12741,43.32%,11.56%
0,第15案,澎湖縣白沙鄉,947,2395,3342,309,3651,8625,42.33%,10.98%
0,第15案,澎湖縣西嶼鄉,684,1598,2282,276,2558,7382,34.65%,9.27%
0,第15案,澎湖縣望安鄉,487,1186,1673,167,1840,4628,39.76%,10.52%
0,第15案,澎湖縣七美鄉,326,614,940,78,1018,3374,30.17%,9.66%
0,第15案,金門縣,10826,30970,41796,2118,43914,122695,35.79%,8.82%
0,第15案,金門縣金城鎮,3241,9347,12588,645,13233,37815,34.99%,8.57%
0,第15案,金門縣金沙鎮,1258,4967,6225,347,6572,18560,35.41%,6.78%
0,第15案,金門縣金湖鎮,2250,6756,9006,490,9496,25915,36.64%,8.68%
0,第15案,金門縣金寧鄉,3170,6573,9743,448,10191,28162,36.19%,11.26%
0,第15案,金門縣烈嶼鄉,869,3202,4071,186,4257,11676,36.46%,7.44%
0,第15案,金門縣烏坵鄉,38,125,163,2,165,567,29.1%,6.7%
0,第15案,連江縣,1480,4110,5590,171,5761,11205,51.41%,13.21%
0,第15案,連江縣南竿鄉,849,2342,3191,98,3289,6461,50.91%,13.14%
0,第15案,連江縣北竿鄉,266,811,1077,33,1110,2125,52.24%,12.52%
0,第15案,連江縣莒光鄉,200,560,760,25,785,1481,53%,13.5%
0,第15案,連江縣東引鄉,165,397,562,15,577,1138,50.7%,14.5%
0,第15案,基隆市,54369,102268,156637,8427,165064,320030,51.58%,16.99%
0,第15案,基隆市中正區,6983,13181,20164,1324,21488,45545,47.18%,15.33%
0,第15案,基隆市七堵區,8017,15107,23124,1356,24480,46256,52.92%,17.33%
0,第15案,基隆市暖暖區,5869,10948,16817,679,17496,33225,52.66%,17.66%
0,第15案,基隆市仁愛區,6390,11793,18183,1326,19509,36738,53.1%,17.39%
0,第15案,基隆市中山區,6929,13362,20291,1097,21388,41856,51.1%,16.55%
0,第15案,基隆市安樂區,12312,22626,34938,1633,36571,70396,51.95%,17.49%
0,第15案,基隆市信義區,7869,15251,23120,1012,24132,46014,52.44%,17.1%
0,第15案,新竹市,67231,123030,190261,8894,199155,351775,56.61%,19.11%
0,第15案,新竹市東區,32753,57090,89843,3696,93539,163757,57.12%,20%
0,第15案,新竹市北區,22925,42900,65825,3223,69048,123122,56.08%,18.62%
0,第15案,新竹市香山區,11553,23040,34593,1975,36568,64896,56.35%,17.8%
0,第15案,嘉義市,39449,75746,115195,5781,120976,221553,54.6%,17.81%
0,第15案,嘉義市東區,18474,33619,52093,2560,54653,100647,54.3%,18.36%
0,第15案,嘉義市西區,20975,42127,63102,3221,66323,120906,54.86%,17.35%
0,第16案,全國,5895560,4014215,9909775,922960,10832735,19757067,54.83%,29.84%
0,第16案,臺北市,698579,494516,1193095,91528,1284623,2228430,57.65%,31.35%
0,第16案,臺北市松山區,55200,38025,93225,6808,100033,169278,59.09%,32.61%
0,第16案,臺北市信義區,60987,41507,102494,7625,110119,190444,57.82%,32.02%
0,第16案,臺北市大安區,80894,55473,136367,8792,145159,252645,57.46%,32.02%
0,第16案,臺北市中山區,58611,44414,103025,8153,111178,195148,56.97%,30.03%
0,第16案,臺北市中正區,41549,28544,70093,4712,74805,128292,58.31%,32.39%
0,第16案,臺北市大同區,31347,25374,56721,5467,62188,107557,57.82%,29.14%
0,第16案,臺北市萬華區,47801,35213,83014,7953,90967,164020,55.46%,29.14%
0,第16案,臺北市文山區,77470,49080,126550,9286,135836,227211,59.78%,34.1%
0,第16案,臺北市南港區,31894,23041,54935,3919,58854,101907,57.75%,31.3%
0,第16案,臺北市內湖區,76531,52585,129116,8726,137842,236824,58.2%,32.32%
0,第16案,臺北市士林區,71992,54662,126654,11331,137985,241854,57.05%,29.77%
0,第16案,臺北市北投區,64303,46598,110901,8756,119657,213250,56.11%,30.15%
0,第16案,新北市,1000493,691936,1692429,162420,1854849,3375513,54.95%,29.64%
0,第16案,新北市板橋區,136267,98719,234986,23859,258845,463411,55.86%,29.41%
0,第16案,新北市三重區,93399,70120,163519,19753,183272,329846,55.56%,28.32%
0,第16案,新北市中和區,110005,70784,180789,15683,196472,355978,55.19%,30.9%
0,第16案,新北市永和區,62766,39572,102338,8109,110447,187798,58.81%,33.42%
0,第16案,新北市新莊區,103947,73997,177944,17707,195651,344981,56.71%,30.13%
0,第16案,新北市新店區,86688,52198,138886,10349,149235,264053,56.52%,32.83%
0,第16案,新北市樹林區,43905,32015,75920,7616,83536,152102,54.92%,28.87%
0,第16案,新北市鶯歌區,19947,14231,34178,3399,37577,71645,52.45%,27.84%
0,第16案,新北市三峽區,26544,18649,45193,4162,49355,94291,52.34%,28.15%
0,第16案,新北市淡水區,42612,29215,71827,5493,77320,147272,52.5%,28.93%
0,第16案,新北市汐止區,50587,33825,84412,7281,91693,173831,52.75%,29.1%
0,第16案,新北市瑞芳區,8893,6104,14997,1750,16747,35036,47.8%,25.38%
0,第16案,新北市土城區,59061,40462,99523,10321,109844,200783,54.71%,29.42%
0,第16案,新北市蘆洲區,46599,34317,80916,8598,89514,167457,53.45%,27.83%
0,第16案,新北市五股區,20000,14792,34792,3684,38476,72443,53.11%,27.61%
0,第16案,新北市泰山區,19053,13363,32416,2930,35346,64252,55.01%,29.65%
0,第16案,新北市林口區,26917,18029,44946,3331,48277,86203,56%,31.23%
0,第16案,新北市深坑區,6116,4199,10315,931,11246,20624,54.53%,29.65%
0,第16案,新北市石碇區,1680,1329,3009,407,3416,6861,49.79%,24.49%
0,第16案,新北市坪林區,1535,1030,2565,390,2955,5891,50.16%,26.06%
0,第16案,新北市三芝區,5087,3686,8773,909,9682,20119,48.12%,25.28%
0,第16案,新北市石門區,2776,2005,4781,667,5448,10528,51.75%,26.37%
0,第16案,新北市八里區,9280,6562,15842,1614,17456,32970,52.95%,28.15%
0,第16案,新北市平溪區,1034,710,1744,293,2037,4321,47.14%,23.93%
0,第16案,新北市雙溪區,2067,1357,3424,450,3874,7999,48.43%,25.84%
0,第16案,新北市貢寮區,2347,2384,4731,454,5185,11279,45.97%,20.81%
0,第16案,新北市金山區,4900,3746,8646,960,9606,18978,50.62%,25.82%
0,第16案,新北市萬里區,4941,3578,8519,1076,9595,19297,49.72%,25.61%
0,第16案,新北市烏來區,1540,958,2498,244,2742,5264,52.09%,29.26%
0,第16案,桃園市,518318,337300,855618,67514,923132,1801823,51.23%,28.77%
0,第16案,桃園市桃園區,101918,67207,169125,12153,181278,359790,50.38%,28.33%
0,第16案,桃園市中壢區,100616,62949,163565,12025,175590,334402,52.51%,30.09%
0,第16案,桃園市大溪區,21913,15074,36987,4116,41103,78285,52.5%,27.99%
0,第16案,桃園市楊梅區,40318,24433,64751,4946,69697,137917,50.54%,29.23%
0,第16案,桃園市蘆竹區,35742,24763,60505,4898,65403,129252,50.6%,27.65%
0,第16案,桃園市大園區,19806,13867,33673,2724,36397,73900,49.25%,26.8%
0,第16案,桃園市龜山區,34915,24612,59527,4651,64178,131702,48.73%,26.51%
0,第16案,桃園市八德區,45937,30421,76358,6782,83140,165065,50.37%,27.83%
0,第16案,桃園市龍潭區,31654,18551,50205,3856,54061,101574,53.22%,31.16%
0,第16案,桃園市平鎮區,55590,34675,90265,6517,96782,183560,52.72%,30.28%
0,第16案,桃園市新屋區,12387,8582,20969,1976,22945,41461,55.34%,29.88%
0,第16案,桃園市觀音區,14918,10234,25152,2399,27551,55149,49.96%,27.05%
0,第16案,桃園市復興區,2604,1932,4536,471,5007,9766,51.27%,26.66%
0,第16案,臺中市,725778,478271,1204049,118994,1323043,2295642,57.63%,31.62%
0,第16案,臺中市中區,4199,3157,7356,859,8215,14696,55.9%,28.57%
0,第16案,臺中市東區,20239,13985,34224,3437,37661,64291,58.58%,31.48%
0,第16案,臺中市南區,34386,23722,58108,5432,63540,103643,61.31%,33.18%
0,第16案,臺中市西區,30092,20956,51048,4312,55360,95040,58.25%,31.66%
0,第16案,臺中市北區,38821,25381,64202,5539,69741,124621,55.96%,31.15%
0,第16案,臺中市西屯區,59399,38045,97444,8825,106269,183814,57.81%,32.31%
0,第16案,臺中市南屯區,45026,29930,74956,6711,81667,135448,60.29%,33.24%
0,第16案,臺中市北屯區,73413,46183,119596,10227,129823,227720,57.01%,32.24%
0,第16案,臺中市豐原區,45002,29882,74884,7011,81895,136658,59.93%,32.93%
0,第16案,臺中市東勢區,13214,9096,22310,2803,25113,43181,58.16%,30.6%
0,第16案,臺中市大甲區,19426,13302,32728,3469,36197,63069,57.39%,30.8%
0,第16案,臺中市清水區,23167,14645,37812,4073,41885,71528,58.56%,32.39%
0,第16案,臺中市沙鹿區,22892,15188,38080,4003,42083,74207,56.71%,30.85%
0,第16案,臺中市梧棲區,14523,9551,24074,2745,26819,47040,57.01%,30.87%
0,第16案,臺中市后里區,14056,9112,23168,2852,26020,44962,57.87%,31.26%
0,第16案,臺中市神岡區,16779,12035,28814,3200,32014,54565,58.67%,30.75%
0,第16案,臺中市潭子區,28569,18357,46926,4041,50967,89487,56.95%,31.93%
0,第16案,臺中市大雅區,24116,15958,40074,3990,44064,77189,57.09%,31.24%
0,第16案,臺中市新社區,5903,3924,9827,1113,10940,20860,52.44%,28.3%
0,第16案,臺中市石岡區,4113,2674,6787,810,7597,12880,58.98%,31.93%
0,第16案,臺中市外埔區,8609,5582,14191,1562,15753,27059,58.22%,31.82%
0,第16案,臺中市大安區,4964,3443,8407,1312,9719,16520,58.83%,30.05%
0,第16案,臺中市烏日區,19358,13048,32406,3521,35927,61705,58.22%,31.37%
0,第16案,臺中市大肚區,14878,9711,24589,2880,27469,47457,57.88%,31.35%
0,第16案,臺中市龍井區,19422,12882,32304,3304,35608,63584,56%,30.55%
0,第16案,臺中市霧峰區,17744,11582,29326,3938,33264,55225,60.23%,32.13%
0,第16案,臺中市太平區,47742,30518,78260,7597,85857,157926,54.37%,30.23%
0,第16案,臺中市大里區,52609,34361,86970,8899,95869,171769,55.81%,30.63%
0,第16案,臺中市和平區,3117,2061,5178,529,5707,9498,60.09%,32.82%
0,第16案,臺南市,422398,310812,733210,72547,805757,1594821,50.52%,26.49%
0,第16案,臺南市新營區,17689,11710,29399,2570,31969,64949,49.22%,27.24%
0,第16案,臺南市鹽水區,5279,3921,9200,1163,10363,22121,46.85%,23.86%
0,第16案,臺南市白河區,5294,3848,9142,1238,10380,24894,41.7%,21.27%
0,第16案,臺南市柳營區,4734,3219,7953,1140,9093,18804,48.36%,25.18%
0,第16案,臺南市後壁區,4616,3468,8084,1305,9389,20841,45.05%,22.15%
0,第16案,臺南市東山區,3372,2451,5823,965,6788,18471,36.75%,18.26%
0,第16案,臺南市麻豆區,9408,7250,16658,1473,18131,37963,47.76%,24.78%
0,第16案,臺南市下營區,5003,3481,8484,1071,9555,20947,45.62%,23.88%
0,第16案,臺南市六甲區,4574,3591,8165,997,9162,19144,47.86%,23.89%
0,第16案,臺南市官田區,4618,3440,8058,770,8828,18675,47.27%,24.73%
0,第16案,臺南市大內區,2110,1454,3564,498,4062,8654,46.94%,24.38%
0,第16案,臺南市佳里區,13974,9415,23389,2567,25956,50407,51.49%,27.72%
0,第16案,臺南市學甲區,5511,4003,9514,1024,10538,22567,46.7%,24.42%
0,第16案,臺南市西港區,5130,3712,8842,880,9722,21564,45.08%,23.79%
0,第16案,臺南市七股區,4511,3087,7598,947,8545,19950,42.83%,22.61%
0,第16案,臺南市將軍區,3964,2778,6742,794,7536,17754,42.45%,22.33%
0,第16案,臺南市北門區,2089,1422,3511,347,3858,9925,38.87%,21.05%
0,第16案,臺南市新化區,10063,7660,17723,2041,19764,37296,52.99%,26.98%
0,第16案,臺南市善化區,10307,7882,18189,1998,20187,39950,50.53%,25.8%
0,第16案,臺南市新市區,8362,6149,14511,1595,16106,30386,53%,27.52%
0,第16案,臺南市安定區,7000,5286,12286,1492,13778,26104,52.78%,26.82%
0,第16案,臺南市山上區,1457,1016,2473,323,2796,6511,42.94%,22.38%
0,第16案,臺南市玉井區,3185,2093,5278,583,5861,12357,47.43%,25.77%
0,第16案,臺南市楠西區,1991,1346,3337,367,3704,8528,43.43%,23.35%
0,第16案,臺南市南化區,1883,1368,3251,395,3646,7786,46.83%,24.18%
0,第16案,臺南市左鎮區,945,707,1652,252,1904,4418,43.1%,21.39%
0,第16案,臺南市仁德區,17804,13064,30868,3028,33896,64632,52.44%,27.55%
0,第16案,臺南市歸仁區,15594,11711,27305,2577,29882,57387,52.07%,27.17%
0,第16案,臺南市關廟區,8203,5835,14038,1425,15463,29913,51.69%,27.42%
0,第16案,臺南市龍崎區,903,638,1541,178,1719,3713,46.3%,24.32%
0,第16案,臺南市永康區,53835,38433,92268,7852,100120,195001,51.34%,27.61%
0,第16案,臺南市東區,44495,32777,77272,5805,83077,153359,54.17%,29.01%
0,第16案,臺南市南區,27903,21566,49469,5463,54932,108650,50.56%,25.68%
0,第16案,臺南市北區,31092,23203,54295,4520,58815,110906,53.03%,28.03%
0,第16案,臺南市安南區,42902,32042,74944,7652,82596,159654,51.73%,26.87%
0,第16案,臺南市安平區,14746,10955,25701,2036,27737,55379,50.09%,26.63%
0,第16案,臺南市中西區,17852,14831,32683,3216,35899,65261,55.01%,27.35%
0,第16案,高雄市,752932,509854,1262786,103906,1366692,2353342,58.07%,31.99%
0,第16案,高雄市鹽埕區,6495,4957,11452,718,12170,21617,56.3%,30.05%
0,第16案,高雄市鼓山區,38075,24959,63034,4429,67463,114979,58.67%,33.11%
0,第16案,高雄市左營區,56269,34699,90968,5957,96925,161367,60.06%,34.87%
0,第16案,高雄市楠梓區,50610,33271,83881,7400,91281,153132,59.61%,33.05%
0,第16案,高雄市三民區,92896,64587,157483,11740,169223,289519,58.45%,32.09%
0,第16案,高雄市新興區,14213,10807,25020,1773,26793,44355,60.41%,32.04%
0,第16案,高雄市前金區,7735,5642,13377,975,14352,23928,59.98%,32.33%
0,第16案,高雄市苓雅區,48433,34428,82861,5536,88397,146786,60.22%,33%
0,第16案,高雄市前鎮區,51114,35025,86139,7418,93557,161797,57.82%,31.59%
0,第16案,高雄市旗津區,6331,4756,11087,1394,12481,24860,50.21%,25.47%
0,第16案,高雄市小港區,42230,28891,71121,5726,76847,132733,57.9%,31.82%
0,第16案,高雄市鳳山區,99747,64662,164409,12511,176920,300510,58.87%,33.19%
0,第16案,高雄市林園區,17898,11604,29502,2976,32478,59129,54.93%,30.27%
0,第16案,高雄市大寮區,29648,20901,50549,4348,54897,97309,56.42%,30.47%
0,第16案,高雄市大樹區,10960,7332,18292,1821,20113,36772,54.7%,29.81%
0,第16案,高雄市大社區,9014,6640,15654,1434,17088,30046,56.87%,30%
0,第16案,高雄市仁武區,24041,15653,39694,2777,42471,73611,57.7%,32.66%
0,第16案,高雄市鳥松區,12625,9306,21931,1688,23619,39191,60.27%,32.21%
0,第16案,高雄市岡山區,28342,17486,45828,3632,49460,81244,60.88%,34.89%
0,第16案,高雄市橋頭區,10396,7679,18075,1959,20034,32565,61.52%,31.92%
0,第16案,高雄市燕巢區,8029,5213,13242,1485,14727,26012,56.62%,30.87%
0,第16案,高雄市田寮區,1690,1101,2791,354,3145,6671,47.14%,25.33%
0,第16案,高雄市阿蓮區,6890,5125,12015,1066,13081,24534,53.32%,28.08%
0,第16案,高雄市路竹區,13627,9698,23325,2365,25690,43850,58.59%,31.08%
0,第16案,高雄市湖內區,7579,5375,12954,1129,14083,25729,54.74%,29.46%
0,第16案,高雄市茄萣區,6925,5453,12378,1454,13832,26212,52.77%,26.42%
0,第16案,高雄市永安區,4103,2707,6810,699,7509,12001,62.57%,34.19%
0,第16案,高雄市彌陀區,5293,3704,8997,1094,10091,16487,61.21%,32.1%
0,第16案,高雄市梓官區,9540,6643,16183,1625,17808,31025,57.4%,30.75%
0,第16案,高雄市旗山區,9653,6402,16055,1698,17753,31996,55.49%,30.17%
0,第16案,高雄市美濃區,10310,6967,17277,1946,19223,35311,54.44%,29.2%
0,第16案,高雄市六龜區,2805,1890,4695,727,5422,11501,47.14%,24.39%
0,第16案,高雄市甲仙區,1329,934,2263,350,2613,5417,48.24%,24.53%
0,第16案,高雄市杉林區,2510,1736,4246,521,4767,10607,44.94%,23.66%
0,第16案,高雄市內門區,3171,2190,5361,778,6139,13002,47.22%,24.39%
0,第16案,高雄市茂林區,637,352,989,80,1069,1615,66.19%,39.44%
0,第16案,高雄市桃源區,1024,632,1656,122,1778,3498,50.83%,29.27%
0,第16案,高雄市那瑪夏區,745,447,1192,201,1393,2424,57.47%,30.73%
0,第16案,新竹縣,139470,93309,232779,17674,250453,445051,56.28%,31.34%
0,第16案,新竹縣竹北市,44987,30205,75192,4581,79773,137129,58.17%,32.81%
0,第16案,新竹縣竹東鎮,23823,15411,39234,3114,42348,78794,53.75%,30.23%
0,第16案,新竹縣新埔鎮,9280,5735,15015,1214,16229,28894,56.17%,32.12%
0,第16案,新竹縣關西鎮,7457,5302,12759,1223,13982,24712,56.58%,30.18%
0,第16案,新竹縣湖口鄉,19891,13229,33120,2434,35554,63511,55.98%,31.32%
0,第16案,新竹縣新豐鄉,14072,9655,23727,1846,25573,45790,55.85%,30.73%
0,第16案,新竹縣芎林鄉,5368,3877,9245,904,10149,17293,58.69%,31.04%
0,第16案,新竹縣橫山鄉,3613,2444,6057,633,6690,11346,58.96%,31.84%
0,第16案,新竹縣北埔鄉,2513,1706,4219,356,4575,8180,55.93%,30.72%
0,第16案,新竹縣寶山鄉,4244,2763,7007,592,7599,12973,58.58%,32.71%
0,第16案,新竹縣峨眉鄉,1579,1102,2681,378,3059,5068,60.36%,31.16%
0,第16案,新竹縣尖石鄉,1697,1279,2976,258,3234,7364,43.92%,23.04%
0,第16案,新竹縣五峰鄉,946,601,1547,141,1688,3997,42.23%,23.67%
0,第16案,苗栗縣,143501,95723,239224,22419,261643,461580,56.68%,31.09%
0,第16案,苗栗縣苗栗市,25170,14843,40013,2874,42887,74249,57.76%,33.9%
0,第16案,苗栗縣苑裡鎮,11583,8373,19956,2201,22157,38890,56.97%,29.78%
0,第16案,苗栗縣通霄鎮,8260,5890,14150,1836,15986,29709,53.81%,27.8%
0,第16案,苗栗縣竹南鎮,21072,14424,35496,2907,38403,68528,56.04%,30.75%
0,第16案,苗栗縣頭份市,26103,17535,43638,3569,47207,83617,56.46%,31.22%
0,第16案,苗栗縣後龍鎮,8788,6427,15215,1800,17015,30948,54.98%,28.4%
0,第16案,苗栗縣卓蘭鎮,4776,3004,7780,816,8596,14772,58.19%,32.33%
0,第16案,苗栗縣大湖鄉,3651,2420,6071,668,6739,12653,53.26%,28.85%
0,第16案,苗栗縣公館鄉,9169,5871,15040,1693,16733,28318,59.09%,32.38%
0,第16案,苗栗縣銅鑼鄉,4875,3100,7975,668,8643,15424,56.04%,31.61%
0,第16案,苗栗縣南庄鄉,2287,1614,3901,420,4321,8784,49.19%,26.04%
0,第16案,苗栗縣頭屋鄉,3430,2160,5590,511,6101,9390,64.97%,36.53%
0,第16案,苗栗縣三義鄉,4396,3171,7567,578,8145,13889,58.64%,31.65%
0,第16案,苗栗縣西湖鄉,1889,1305,3194,329,3523,6382,55.2%,29.6%
0,第16案,苗栗縣造橋鄉,3386,2359,5745,676,6421,11027,58.23%,30.71%
0,第16案,苗栗縣三灣鄉,1768,1224,2992,381,3373,5852,57.64%,30.21%
0,第16案,苗栗縣獅潭鄉,1151,684,1835,192,2027,3968,51.08%,29.01%
0,第16案,苗栗縣泰安鄉,1747,1319,3066,300,3366,5180,64.98%,33.73%
0,第16案,彰化縣,328349,223084,551433,58500,609933,1066994,57.16%,30.77%
0,第16案,彰化縣彰化市,61812,43718,105530,9670,115200,190995,60.32%,32.36%
0,第16案,彰化縣鹿港鎮,21577,14980,36557,4143,40700,70505,57.73%,30.6%
0,第16案,彰化縣和美鎮,23210,15941,39151,3495,42646,75286,56.65%,30.83%
0,第16案,彰化縣線西鄉,4647,2949,7596,799,8395,14065,59.69%,33.04%
0,第16案,彰化縣伸港鄉,9449,6096,15545,1686,17231,30407,56.67%,31.08%
0,第16案,彰化縣福興鄉,11401,7659,19060,2364,21424,39745,53.9%,28.69%
0,第16案,彰化縣秀水鄉,10186,7197,17383,1823,19206,32394,59.29%,31.44%
0,第16案,彰化縣花壇鄉,12086,8503,20589,2152,22741,38924,58.42%,31.05%
0,第16案,彰化縣芬園鄉,6153,4024,10177,1147,11324,20408,55.49%,30.15%
0,第16案,彰化縣員林市,32021,21152,53173,4579,57752,102028,56.6%,31.38%
0,第16案,彰化縣溪湖鎮,14324,9370,23694,2462,26156,45147,57.94%,31.73%
0,第16案,彰化縣田中鎮,10701,7580,18281,2128,20409,35391,57.67%,30.24%
0,第16案,彰化縣大村鄉,10080,6700,16780,1719,18499,31492,58.74%,32.01%
0,第16案,彰化縣埔鹽鄉,9245,5822,15067,1792,16859,28026,60.15%,32.99%
0,第16案,彰化縣埔心鄉,9909,6543,16452,1732,18184,29642,61.35%,33.43%
0,第16案,彰化縣永靖鄉,9888,6806,16694,1882,18576,31239,59.46%,31.65%
0,第16案,彰化縣社頭鄉,11509,7432,18941,1840,20781,36306,57.24%,31.7%
0,第16案,彰化縣二水鄉,4055,2953,7008,935,7943,13339,59.55%,30.4%
0,第16案,彰化縣北斗鎮,8622,5815,14437,1661,16098,27593,58.34%,31.25%
0,第16案,彰化縣二林鎮,11880,8187,20067,2470,22537,42976,52.44%,27.64%
0,第16案,彰化縣田尾鄉,7479,4855,12334,1343,13677,23179,59.01%,32.27%
0,第16案,彰化縣埤頭鄉,7504,4793,12297,1683,13980,25677,54.45%,29.22%
0,第16案,彰化縣芳苑鄉,7397,4898,12295,1925,14220,29291,48.55%,25.25%
0,第16案,彰化縣大城鄉,2976,1899,4875,748,5623,14713,38.22%,20.23%
0,第16案,彰化縣竹塘鄉,3597,2360,5957,870,6827,12821,53.25%,28.06%
0,第16案,彰化縣溪州鄉,6641,4852,11493,1452,12945,25405,50.95%,26.14%
0,第16案,南投縣,138860,85227,224087,21345,245432,427089,57.47%,32.51%
0,第16案,南投縣南投市,29595,17785,47380,3612,50992,84328,60.47%,35.1%
0,第16案,南投縣埔里鎮,22085,13740,35825,3508,39333,68763,57.2%,32.12%
0,第16案,南投縣草屯鎮,27449,17070,44519,3385,47904,82922,57.77%,33.1%
0,第16案,南投縣竹山鎮,14566,8897,23463,2384,25847,47034,54.95%,30.97%
0,第16案,南投縣集集鎮,3091,1875,4966,575,5541,9611,57.65%,32.16%
0,第16案,南投縣名間鄉,11108,6888,17996,2013,20009,33408,59.89%,33.25%
0,第16案,南投縣鹿谷鄉,4793,2872,7665,871,8536,15941,53.55%,30.07%
0,第16案,南投縣中寮鄉,4091,2681,6772,843,7615,13181,57.77%,31.04%
0,第16案,南投縣魚池鄉,4192,2636,6828,753,7581,13958,54.31%,30.03%
0,第16案,南投縣國姓鄉,5164,3258,8422,888,9310,16597,56.09%,31.11%
0,第16案,南投縣水里鄉,4806,2957,7763,805,8568,15458,55.43%,31.09%
0,第16案,南投縣信義鄉,4054,2328,6382,1136,7518,13299,56.53%,30.48%
0,第16案,南投縣仁愛鄉,3866,2240,6106,572,6678,12589,53.05%,30.71%
0,第16案,雲林縣,158850,106155,265005,33678,298683,584480,51.1%,27.18%
0,第16案,雲林縣斗六市,28906,18421,47327,3746,51073,89761,56.9%,32.2%
0,第16案,雲林縣斗南鎮,11322,8111,19433,2068,21501,38138,56.38%,29.69%
0,第16案,雲林縣虎尾鎮,16809,11246,28055,2608,30663,58167,52.72%,28.9%
0,第16案,雲林縣西螺鎮,10492,7068,17560,2385,19945,38142,52.29%,27.51%
0,第16案,雲林縣土庫鎮,6582,4488,11070,1639,12709,24412,52.06%,26.96%
0,第16案,雲林縣北港鎮,9640,6339,15979,2471,18450,33958,54.33%,28.39%
0,第16案,雲林縣古坑鄉,7747,4974,12721,1572,14293,27477,52.02%,28.19%
0,第16案,雲林縣大埤鄉,4411,3055,7466,964,8430,16509,51.06%,26.72%
0,第16案,雲林縣莿桐鄉,7018,4785,11803,1771,13574,24570,55.25%,28.56%
0,第16案,雲林縣林內鄉,4482,3064,7546,1172,8718,15551,56.06%,28.82%
0,第16案,雲林縣二崙鄉,5577,3875,9452,1550,11002,23367,47.08%,23.87%
0,第16案,雲林縣崙背鄉,5216,3642,8858,1205,10063,21050,47.81%,24.78%
0,第16案,雲林縣麥寮鄉,9483,6353,15836,2130,17966,37119,48.4%,25.55%
0,第16案,雲林縣東勢鄉,3325,2250,5575,921,6496,13239,49.07%,25.12%
0,第16案,雲林縣褒忠鄉,3057,2066,5123,634,5757,11381,50.58%,26.86%
0,第16案,雲林縣臺西鄉,5070,3141,8211,1334,9545,21125,45.18%,24%
0,第16案,雲林縣元長鄉,4869,3423,8292,1334,9626,22830,42.16%,21.33%
0,第16案,雲林縣四湖鄉,4108,2841,6949,1160,8109,20983,38.65%,19.58%
0,第16案,雲林縣口湖鄉,5828,3728,9556,1668,11224,24193,46.39%,24.09%
0,第16案,雲林縣水林鄉,4908,3285,8193,1346,9539,22508,42.38%,21.81%
0,第16案,嘉義縣,114627,81395,196022,24668,220690,442775,49.84%,25.89%
0,第16案,嘉義縣太保市,8778,6106,14884,1610,16494,31568,52.25%,27.81%
0,第16案,嘉義縣朴子市,9407,6717,16124,1863,17987,35191,51.11%,26.73%
0,第16案,嘉義縣布袋鎮,6202,3859,10061,1433,11494,23965,47.96%,25.88%
0,第16案,嘉義縣大林鎮,7123,5269,12392,1275,13667,26922,50.77%,26.46%
0,第16案,嘉義縣民雄鄉,16658,12239,28897,3683,32580,61209,53.23%,27.21%
0,第16案,嘉義縣溪口鄉,3260,2464,5724,785,6509,13105,49.67%,24.88%
0,第16案,嘉義縣新港鄉,7286,5235,12521,1950,14471,27342,52.93%,26.65%
0,第16案,嘉義縣六腳鄉,4311,3010,7321,1086,8407,20821,40.38%,20.71%
0,第16案,嘉義縣東石鄉,4402,2914,7316,1232,8548,21915,39.01%,20.09%
0,第16案,嘉義縣義竹鄉,4391,2845,7236,1060,8296,16647,49.83%,26.38%
0,第16案,嘉義縣鹿草鄉,3282,2280,5562,984,6546,13937,46.97%,23.55%
0,第16案,嘉義縣水上鄉,12155,8383,20538,2377,22915,43857,52.25%,27.72%
0,第16案,嘉義縣中埔鄉,9376,6797,16173,1836,18009,39139,46.01%,23.96%
0,第16案,嘉義縣竹崎鄉,8088,6112,14200,1512,15712,31228,50.31%,25.9%
0,第16案,嘉義縣梅山鄉,4757,3413,8170,1104,9274,17083,54.29%,27.85%
0,第16案,嘉義縣番路鄉,2849,2154,5003,594,5597,10156,55.11%,28.05%
0,第16案,嘉義縣大埔鄉,1165,789,1954,171,2125,3999,53.14%,29.13%
0,第16案,嘉義縣阿里山鄉,1137,809,1946,113,2059,4691,43.89%,24.24%
0,第16案,屏東縣,192218,136052,328270,37207,365477,711720,51.35%,27.01%
0,第16案,屏東縣屏東市,49795,33508,83303,6333,89636,170148,52.68%,29.27%
0,第16案,屏東縣潮州鎮,12945,9090,22035,2015,24050,46444,51.78%,27.87%
0,第16案,屏東縣東港鎮,10468,7821,18289,2619,20908,39495,52.94%,26.5%
0,第16案,屏東縣恆春鎮,6226,4698,10924,960,11884,25661,46.31%,24.26%
0,第16案,屏東縣萬丹鄉,11618,8736,20354,2563,22917,43478,52.71%,26.72%
0,第16案,屏東縣長治鄉,7444,5185,12629,1651,14280,26256,54.39%,28.35%
0,第16案,屏東縣麟洛鄉,2935,2239,5174,450,5624,9970,56.41%,29.44%
0,第16案,屏東縣九如鄉,5096,3903,8999,1365,10364,19132,54.17%,26.64%
0,第16案,屏東縣里港鄉,5945,4656,10601,1515,12116,22128,54.75%,26.87%
0,第16案,屏東縣鹽埔鄉,6046,4102,10148,1231,11379,22402,50.79%,26.99%
0,第16案,屏東縣高樹鄉,5343,3843,9186,1330,10516,21697,48.47%,24.63%
0,第16案,屏東縣萬巒鄉,4477,3300,7777,1161,8938,17945,49.81%,24.95%
0,第16案,屏東縣內埔鄉,11406,8400,19806,2085,21891,47558,46.03%,23.98%
0,第16案,屏東縣竹田鄉,4466,3319,7785,1011,8796,15353,57.29%,29.09%
0,第16案,屏東縣新埤鄉,2253,1670,3923,570,4493,9033,49.74%,24.94%
0,第16案,屏東縣枋寮鄉,5747,3997,9744,1532,11276,21394,52.71%,26.86%
0,第16案,屏東縣新園鄉,8152,5749,13901,2109,16010,30706,52.14%,26.55%
0,第16案,屏東縣崁頂鄉,3357,2348,5705,642,6347,12270,51.73%,27.36%
0,第16案,屏東縣林邊鄉,4367,3224,7591,1044,8635,15691,55.03%,27.83%
0,第16案,屏東縣南州鄉,2503,1871,4374,595,4969,9479,52.42%,26.41%
0,第16案,屏東縣佳冬鄉,4194,3005,7199,1063,8262,17063,48.42%,24.58%
0,第16案,屏東縣琉球鄉,2507,1521,4028,602,4630,10706,43.25%,23.42%
0,第16案,屏東縣車城鄉,1562,1186,2748,315,3063,7595,40.33%,20.57%
0,第16案,屏東縣滿州鄉,1611,1165,2776,257,3033,7206,42.09%,22.36%
0,第16案,屏東縣枋山鄉,1283,869,2152,282,2434,4856,50.12%,26.42%
0,第16案,屏東縣三地門鄉,1712,1155,2867,370,3237,6373,50.79%,26.86%
0,第16案,屏東縣霧臺鄉,823,626,1449,134,1583,2950,53.66%,27.9%
0,第16案,屏東縣瑪家鄉,1873,1134,3007,276,3283,5663,57.97%,33.07%
0,第16案,屏東縣泰武鄉,1410,943,2353,350,2703,4344,62.22%,32.46%
0,第16案,屏東縣來義鄉,2124,1037,3161,425,3586,6257,57.31%,33.95%
0,第16案,屏東縣春日鄉,546,409,955,81,1036,3923,26.41%,13.92%
0,第16案,屏東縣獅子鄉,1027,676,1703,154,1857,4230,43.9%,24.28%
0,第16案,屏東縣牡丹鄉,957,667,1624,117,1741,4314,40.36%,22.18%
0,第16案,宜蘭縣,111743,77082,188825,23921,212746,386089,55.1%,28.94%
0,第16案,宜蘭縣宜蘭市,23936,16264,40200,4447,44647,79167,56.4%,30.23%
0,第16案,宜蘭縣羅東鎮,17459,12335,29794,3348,33142,57686,57.45%,30.27%
0,第16案,宜蘭縣蘇澳鎮,10050,6665,16715,2561,19276,34512,55.85%,29.12%
0,第16案,宜蘭縣頭城鎮,6953,5011,11964,1829,13793,25135,54.88%,27.66%
0,第16案,宜蘭縣礁溪鄉,8806,6001,14807,1847,16654,31084,53.58%,28.33%
0,第16案,宜蘭縣壯圍鄉,6234,4316,10550,1720,12270,21447,57.21%,29.07%
0,第16案,宜蘭縣員山鄉,7442,5549,12991,2074,15065,28131,53.55%,26.45%
0,第16案,宜蘭縣冬山鄉,13244,8821,22065,2198,24263,45405,53.44%,29.17%
0,第16案,宜蘭縣五結鄉,9815,6809,16624,1991,18615,34892,53.35%,28.13%
0,第16案,宜蘭縣三星鄉,5091,3657,8748,1215,9963,19051,52.3%,26.72%
0,第16案,宜蘭縣大同鄉,1222,807,2029,362,2391,4935,48.45%,24.76%
0,第16案,宜蘭縣南澳鄉,1491,847,2338,329,2667,4644,57.43%,32.11%
0,第16案,花蓮縣,80187,50311,130498,14411,144909,278059,52.11%,28.84%
0,第16案,花蓮縣花蓮市,26165,15949,42114,3409,45523,84807,53.68%,30.85%
0,第16案,花蓮縣鳳林鎮,2844,1790,4634,664,5298,9676,54.75%,29.39%
0,第16案,花蓮縣玉里鎮,5053,3251,8304,1398,9702,20650,46.98%,24.47%
0,第16案,花蓮縣新城鄉,5139,3191,8330,859,9189,17029,53.96%,30.18%
0,第16案,花蓮縣吉安鄉,21528,13261,34789,3172,37961,72116,52.64%,29.85%
0,第16案,花蓮縣壽豐鄉,4465,3251,7716,1037,8753,15847,55.23%,28.18%
0,第16案,花蓮縣光復鄉,3023,1911,4934,875,5809,11417,50.88%,26.48%
0,第16案,花蓮縣豐濱鄉,940,657,1597,337,1934,4395,44%,21.39%
0,第16案,花蓮縣瑞穗鄉,2656,1672,4328,702,5030,10279,48.93%,25.84%
0,第16案,花蓮縣富里鄉,2133,1402,3535,595,4130,9065,45.56%,23.53%
0,第16案,花蓮縣秀林鄉,3423,2036,5459,557,6016,12562,47.89%,27.25%
0,第16案,花蓮縣萬榮鄉,1438,1013,2451,417,2868,5269,54.43%,27.29%
0,第16案,花蓮縣卓溪鄉,1380,927,2307,389,2696,4947,54.5%,27.9%
0,第16案,臺東縣,51032,33932,84964,9433,94397,185996,50.75%,27.44%
0,第16案,臺東縣臺東市,27095,16947,44042,3485,47527,87803,54.13%,30.86%
0,第16案,臺東縣成功鎮,3232,2001,5233,855,6088,12426,48.99%,26.01%
0,第16案,臺東縣關山鎮,2106,1315,3421,279,3700,7509,49.27%,28.05%
0,第16案,臺東縣卑南鄉,4065,2819,6884,921,7805,14976,52.12%,27.14%
0,第16案,臺東縣鹿野鄉,1629,1129,2758,339,3097,6936,44.65%,23.49%
0,第16案,臺東縣池上鄉,1706,1169,2875,380,3255,7162,45.45%,23.82%
0,第16案,臺東縣東河鄉,1629,1177,2806,442,3248,7635,42.54%,21.34%
0,第16案,臺東縣長濱鄉,1269,840,2109,489,2598,6484,40.07%,19.57%
0,第16案,臺東縣太麻里鄉,2359,1612,3971,614,4585,9666,47.43%,24.41%
0,第16案,臺東縣大武鄉,1216,902,2118,559,2677,5266,50.84%,23.09%
0,第16案,臺東縣綠島鄉,902,553,1455,98,1553,3579,43.39%,25.2%
0,第16案,臺東縣海端鄉,855,685,1540,194,1734,3278,52.9%,26.08%
0,第16案,臺東縣延平鄉,736,598,1334,193,1527,2930,52.12%,25.12%
0,第16案,臺東縣金峰鄉,847,563,1410,235,1645,3028,54.33%,27.97%
0,第16案,臺東縣達仁鄉,752,805,1557,220,1777,3137,56.65%,23.97%
0,第16案,臺東縣蘭嶼鄉,634,817,1451,130,1581,4181,37.81%,15.16%
0,第16案,澎湖縣,22697,13207,35904,4253,40157,90405,44.42%,25.11%
0,第16案,澎湖縣馬公市,14870,8619,23489,2443,25932,53655,48.33%,27.71%
0,第16案,澎湖縣湖西鄉,3078,1727,4805,585,5390,12741,42.3%,24.16%
0,第16案,澎湖縣白沙鄉,2003,1180,3183,432,3615,8625,41.91%,23.22%
0,第16案,澎湖縣西嶼鄉,1266,768,2034,410,2444,7382,33.11%,17.15%
0,第16案,澎湖縣望安鄉,945,573,1518,259,1777,4628,38.4%,20.42%
0,第16案,澎湖縣七美鄉,535,340,875,124,999,3374,29.61%,15.86%
0,第16案,金門縣,26851,13274,40125,3668,43793,122695,35.69%,21.88%
0,第16案,金門縣金城鎮,8057,3974,12031,1131,13162,37815,34.81%,21.31%
0,第16案,金門縣金沙鎮,3999,1972,5971,591,6562,18560,35.36%,21.55%
0,第16案,金門縣金湖鎮,5762,2819,8581,902,9483,25915,36.59%,22.23%
0,第16案,金門縣金寧鄉,6132,3276,9408,760,10168,28162,36.11%,21.77%
0,第16案,金門縣烈嶼鄉,2806,1171,3977,276,4253,11676,36.43%,24.03%
0,第16案,金門縣烏坵鄉,95,62,157,8,165,567,29.1%,16.75%
0,第16案,連江縣,3764,1663,5427,323,5750,11205,51.32%,33.59%
0,第16案,連江縣南竿鄉,2201,903,3104,173,3277,6461,50.72%,34.07%
0,第16案,連江縣北竿鄉,707,336,1043,67,1110,2125,52.24%,33.27%
0,第16案,連江縣莒光鄉,502,224,726,57,783,1481,52.87%,33.9%
0,第16案,連江縣東引鄉,354,200,554,26,580,1138,50.97%,31.11%
0,第16案,基隆市,90311,61447,151758,11852,163610,320030,51.12%,28.22%
0,第16案,基隆市中正區,11413,8035,19448,1862,21310,45545,46.79%,25.06%
0,第16案,基隆市七堵區,13203,9184,22387,1907,24294,46256,52.52%,28.54%
0,第16案,基隆市暖暖區,9712,6477,16189,1036,17225,33225,51.84%,29.23%
0,第16案,基隆市仁愛區,10277,7453,17730,1847,19577,36738,53.29%,27.97%
0,第16案,基隆市中山區,11495,8015,19510,1513,21023,41856,50.23%,27.46%
0,第16案,基隆市安樂區,20635,13539,34174,2201,36375,70396,51.67%,29.31%
0,第16案,基隆市信義區,13576,8744,22320,1486,23806,46014,51.74%,29.5%
0,第16案,新竹市,110083,73690,183773,13635,197408,351775,56.12%,31.29%
0,第16案,新竹市東區,52428,34488,86916,5835,92751,163757,56.64%,32.02%
0,第16案,新竹市北區,37623,25982,63605,4918,68523,123122,55.65%,30.56%
0,第16案,新竹市香山區,20032,13220,33252,2882,36134,64896,55.68%,30.87%
0,第16案,嘉義市,64519,45975,110494,9064,119558,221553,53.96%,29.12%
0,第16案,嘉義市東區,29288,21014,50302,4070,54372,100647,54.02%,29.1%
0,第16案,嘉義市西區,35231,24961,60192,4994,65186,120906,53.91%,29.14%
